City/Town,Ward,Pct,Maura Healey,Sonia Rosa Chang-Diaz,All Others,Blanks,Total Votes Cast
Abington,-,1,248,30,1,7,286
Abington,-,2,233,32,3,6,274
Abington,-,3,251,54,4,7,316
Abington,-,4,270,48,1,4,323
Abington,-,5,274,39,0,5,318
Acton,-,1,343,49,0,10,402
Acton,-,2,550,62,1,22,635
Acton,-,3,645,78,0,7,730
Acton,-,4,485,89,2,14,590
Acton,-,5,515,66,2,17,600
Acton,-,6,396,36,0,6,438
Acton,-,6A,157,18,0,2,177
Acton,-,7,441,51,0,12,504
Acushnet,-,1,247,61,0,7,315
Acushnet,-,2,199,51,2,7,259
Acushnet,-,2A,24,3,0,1,28
Acushnet,-,3,256,71,2,11,340
Adams,-,1,177,47,0,16,240
Adams,-,2,218,46,0,13,277
Adams,-,3,205,40,1,25,271
Adams,-,4,178,33,1,10,222
Adams,-,5,265,55,0,28,348
Agawam,-,1,183,41,0,8,232
Agawam,-,2,284,49,1,21,355
Agawam,-,3,228,36,1,15,280
Agawam,-,4,189,42,1,14,246
Agawam,-,5,302,63,0,15,380
Agawam,-,6,237,44,0,13,294
Agawam,-,7,273,40,1,13,327
Agawam,-,8,297,49,0,11,357
Alford,-,1,86,10,0,6,102
Amesbury,-,1,423,40,1,12,476
Amesbury,-,2,345,38,0,8,391
Amesbury,-,3,425,40,0,5,470
Amesbury,-,4,234,27,0,8,269
Amesbury,-,5,311,37,0,10,358
Amesbury,-,6,282,49,0,7,338
Amherst,-,1A,285,43,2,4,334
Amherst,-,1B,153,18,0,2,173
Amherst,-,2A,183,17,0,5,205
Amherst,-,2B,513,57,1,5,576
Amherst,-,3A,180,26,0,3,209
Amherst,-,3B,426,76,0,17,519
Amherst,-,4A,277,41,0,12,330
Amherst,-,4B,160,15,0,5,180
Amherst,-,5A,158,25,1,4,188
Amherst,-,5B,890,57,2,13,962
Andover,-,1,289,38,0,5,332
Andover,-,2,350,55,3,2,410
Andover,-,3,476,52,3,8,539
Andover,-,4,201,29,0,9,239
Andover,-,4A,70,26,0,1,97
Andover,-,5,355,57,1,5,418
Andover,-,6,286,30,3,5,324
Andover,-,7,363,41,1,15,420
Andover,-,8,408,65,1,17,491
Andover,-,9,348,42,1,8,399
Andover,-,10,401,33,0,9,443
Aquinnah,-,1,103,17,0,4,124
Arlington,-,1,205,45,2,6,258
Arlington,-,2,421,62,0,13,496
Arlington,-,3,405,54,1,8,468
Arlington,-,4,353,60,2,4,419
Arlington,-,5,403,52,0,7,462
Arlington,-,6,395,43,0,7,445
Arlington,-,7,388,45,3,6,442
Arlington,-,8,476,47,1,12,536
Arlington,-,9,304,57,0,9,370
Arlington,-,10,528,50,0,5,583
Arlington,-,11,386,55,1,8,450
Arlington,-,12,579,42,0,3,624
Arlington,-,13,391,27,0,7,425
Arlington,-,14,373,32,0,5,410
Arlington,-,15,368,30,1,5,404
Arlington,-,16,423,40,0,9,472
Arlington,-,17,306,48,0,3,357
Arlington,-,18,352,30,0,8,390
Arlington,-,19,461,32,0,7,500
Arlington,-,20,386,49,0,8,443
Arlington,-,21,394,46,0,6,446
Ashburnham,-,1,254,37,0,0,291
Ashburnham,-,2,264,36,1,6,307
Ashby,-,1,274,36,0,3,313
Ashfield,-,1,346,39,0,9,394
Ashland,-,1,266,45,0,3,314
Ashland,-,2,369,52,0,5,426
Ashland,-,3,273,35,0,5,313
Ashland,-,4,294,39,0,5,338
Ashland,-,5,339,37,0,6,382
Ashland,-,6,355,47,0,6,408
Athol,-,1,236,49,0,5,290
Athol,-,2,172,34,1,0,207
Athol,-,3,215,34,0,1,250
Attleboro,1,A,199,52,0,14,265
Attleboro,1,B,186,39,1,2,228
Attleboro,2,A,319,70,1,13,403
Attleboro,2,B,224,54,1,6,285
Attleboro,3,A,334,68,0,6,408
Attleboro,3,B,282,50,2,2,336
Attleboro,4,A,206,50,0,11,267
Attleboro,4,B,314,59,2,17,392
Attleboro,5,A,169,39,0,3,211
Attleboro,5,B,257,58,0,5,320
Attleboro,6,A,228,50,2,5,285
Attleboro,6,B,276,54,0,5,335
Auburn,-,1,296,40,0,5,341
Auburn,-,2,293,29,0,8,330
Auburn,-,3,323,45,0,5,373
Auburn,-,4,267,52,0,3,322
Auburn,-,5,275,52,1,3,331
Avon,-,1,382,69,0,8,459
Ayer,-,1,216,50,0,3,269
Ayer,-,2,295,32,0,7,334
Ayer,-,3,187,38,0,2,227
Barnstable,-,1,592,47,0,11,650
Barnstable,-,2,458,50,0,11,519
Barnstable,-,3,353,38,0,7,398
Barnstable,-,4,450,46,0,3,499
Barnstable,-,5,559,36,1,0,596
Barnstable,-,6,434,39,1,6,480
Barnstable,-,7,542,59,1,7,609
Barnstable,-,8,258,55,0,3,316
Barnstable,-,9,84,22,0,1,107
Barnstable,-,10,140,14,2,5,161
Barnstable,-,11,242,30,0,1,273
Barnstable,-,12,195,19,0,5,219
Barnstable,-,13,279,42,1,6,328
Barre,-,1,200,42,0,0,242
Barre,-,2,162,20,0,1,183
Becket,-,1,216,52,4,17,289
Bedford,-,1,563,64,1,11,639
Bedford,-,2,285,38,0,8,331
Bedford,-,2A,110,10,0,2,122
Bedford,-,3,627,59,0,7,693
Bedford,-,4,529,53,2,15,599
Belchertown,-,A,526,75,0,10,611
Belchertown,-,B,379,59,0,14,452
Belchertown,-,C,456,58,0,14,528
Belchertown,-,D,558,80,2,6,646
Bellingham,-,1,219,33,0,5,257
Bellingham,-,2,278,24,2,1,305
Bellingham,-,3,280,37,0,7,324
Bellingham,-,4,193,19,0,3,215
Bellingham,-,5,169,41,1,4,215
Belmont,-,1,502,36,0,15,553
Belmont,-,2,467,51,0,8,526
Belmont,-,3,415,55,1,12,483
Belmont,-,4,330,64,1,6,401
Belmont,-,5,419,56,0,16,491
Belmont,-,6,668,62,0,14,744
Belmont,-,7,430,60,2,5,497
Belmont,-,8,405,44,0,10,459
Berkley,-,1,235,40,2,7,284
Berkley,-,2,167,34,0,9,210
Berlin,-,1,415,77,1,6,499
Bernardston,-,1,217,42,0,5,264
Beverly,1,1,360,47,1,7,415
Beverly,1,2,468,59,2,12,541
Beverly,2,1,379,78,0,11,468
Beverly,2,2,507,67,1,9,584
Beverly,3,1,238,60,0,7,305
Beverly,3,2,404,35,4,11,454
Beverly,4,1,264,23,0,13,300
Beverly,4,2,754,78,3,13,848
Beverly,5,1,471,58,1,17,547
Beverly,5,2,386,59,2,7,454
Beverly,6,1,538,65,2,17,622
Beverly,6,2,511,68,1,22,602
Billerica,-,1,253,42,2,7,304
Billerica,-,2,292,55,2,5,354
Billerica,-,3,253,62,4,2,321
Billerica,-,4,263,43,0,6,312
Billerica,-,5,360,51,1,12,424
Billerica,-,6,247,46,0,4,297
Billerica,-,7,307,45,1,3,356
Billerica,-,8,254,53,1,6,314
Billerica,-,9,249,36,1,7,293
Billerica,-,10,276,52,2,4,334
Billerica,-,11,212,43,5,6,266
Billerica,-,12,289,57,2,7,355
Blackstone,-,1,144,27,0,1,172
Blackstone,-,2,171,28,0,1,200
Blackstone,-,3,159,32,0,0,191
Blandford,-,1,99,8,0,1,108
Bolton,-,1,785,87,1,6,879
Boston,1,1,206,45,1,8,260
Boston,1,2,107,25,1,10,143
Boston,1,3,375,86,2,14,477
Boston,1,4,127,24,2,3,156
Boston,1,5,142,49,1,5,197
Boston,1,6,132,33,1,6,172
Boston,1,7,114,39,0,4,157
Boston,1,8,168,33,1,1,203
Boston,1,9,114,26,1,4,145
Boston,1,10,60,9,0,4,73
Boston,1,11,172,46,2,16,236
Boston,1,12,159,34,3,19,215
Boston,1,13,206,45,3,12,266
Boston,1,14,94,33,1,8,136
Boston,1,15,0,0,0,0,0
Boston,2,1,335,27,5,25,392
Boston,2,2,307,33,2,6,348
Boston,2,3,405,27,3,18,453
Boston,2,4,346,22,5,12,385
Boston,2,5,343,25,0,14,382
Boston,2,6,298,22,0,13,333
Boston,2,7,173,31,0,4,208
Boston,2,8,125,32,1,13,171
Boston,3,1,293,33,0,23,349
Boston,3,2,299,25,1,16,341
Boston,3,3,140,25,2,12,179
Boston,3,4,157,22,1,9,189
Boston,3,5,296,43,1,6,346
Boston,3,6,148,17,2,5,172
Boston,3,7,302,27,2,8,339
Boston,3,8,164,30,0,4,198
Boston,3,9,198,32,1,10,241
Boston,3,10,223,46,1,10,280
Boston,3,11,216,34,1,12,263
Boston,3,12,385,55,2,15,457
Boston,3,13,221,17,0,5,243
Boston,3,13A,0,0,0,0,0
Boston,3,14,299,50,1,16,366
Boston,3,15,162,17,0,1,180
Boston,3,16,430,48,2,6,486
Boston,3,17,207,36,6,8,257
Boston,4,1,276,28,0,8,312
Boston,4,2,219,25,2,4,250
Boston,4,3,368,59,4,9,440
Boston,4,4,329,50,1,14,394
Boston,4,5,283,44,2,5,334
Boston,4,6,214,24,2,2,242
Boston,4,7,195,41,0,5,241
Boston,4,8,167,38,4,5,214
Boston,4,9,25,23,0,5,53
Boston,4,10,33,4,0,3,40
Boston,4,10A,0,0,0,0,0
Boston,4,11,12,2,0,0,14
Boston,4,12,71,13,0,3,87
Boston,5,1,183,53,0,3,239
Boston,5,2,167,46,0,3,216
Boston,5,3,369,32,1,11,413
Boston,5,4,175,36,1,3,215
Boston,5,5,287,13,1,14,315
Boston,5,6,276,33,2,8,319
Boston,5,7,328,37,1,16,382
Boston,5,8,279,34,1,9,323
Boston,5,9,266,21,2,5,294
Boston,5,10,113,25,1,6,145
Boston,5,11,103,12,2,4,121
Boston,5,12,116,30,0,0,146
Boston,5,13,298,27,1,4,330
Boston,5,14,270,23,2,5,300
Boston,5,15,145,17,2,0,164
Boston,6,1,292,40,4,7,343
Boston,6,2,118,44,0,5,167
Boston,6,3,167,32,0,11,210
Boston,6,4,132,20,1,12,165
Boston,6,5,187,24,2,9,222
Boston,6,6,204,43,4,29,280
Boston,6,7,154,21,5,30,210
Boston,6,8,231,32,3,44,310
Boston,6,9,199,46,4,42,291
Boston,6,10,143,31,0,9,183
Boston,6,11,252,29,1,5,287
Boston,6,12,221,26,2,5,254
Boston,6,12A,0,0,0,0,0
Boston,7,1,173,42,5,39,259
Boston,7,2,216,27,5,32,280
Boston,7,3,273,39,10,34,356
Boston,7,4,153,29,0,16,198
Boston,7,5,145,33,1,14,193
Boston,7,6,119,34,5,11,169
Boston,7,7,66,34,0,3,103
Boston,7,8,155,31,2,8,196
Boston,7,9,123,19,0,5,147
Boston,7,10,130,64,0,14,208
Boston,8,1,300,50,1,5,356
Boston,8,2,279,36,1,8,324
Boston,8,3,135,86,1,8,230
Boston,8,4,117,44,1,3,165
Boston,8,5,184,121,3,30,338
Boston,8,6,29,29,0,0,58
Boston,8,6A,0,0,0,0,0
Boston,9,1,300,85,0,13,398
Boston,9,2,258,52,1,2,313
Boston,9,3,138,74,1,7,220
Boston,9,4,182,87,0,10,279
Boston,9,5,212,126,5,9,352
Boston,9,6,214,57,0,12,283
Boston,9,7,28,14,0,0,42
Boston,10,1,153,63,1,0,217
Boston,10,2,80,38,1,5,124
Boston,10,3,84,45,0,4,133
Boston,10,4,165,85,0,9,259
Boston,10,5,146,62,4,3,215
Boston,10,6,153,99,0,4,256
Boston,10,7,137,114,1,10,262
Boston,10,8,308,106,2,11,427
Boston,10,9,447,137,1,10,595
Boston,10,9A,0,0,0,0,0
Boston,11,1,161,48,2,7,218
Boston,11,2,216,91,1,9,317
Boston,11,3,136,72,2,3,213
Boston,11,4,237,136,2,11,386
Boston,11,5,213,134,0,14,361
Boston,11,6,274,88,0,9,371
Boston,11,7,302,128,0,9,439
Boston,11,8,494,170,1,7,672
Boston,11,9,297,100,0,11,408
Boston,11,10,270,117,0,2,389
Boston,12,1,182,104,1,8,295
Boston,12,2,249,137,1,28,415
Boston,12,3,118,59,0,6,183
Boston,12,4,130,63,1,7,201
Boston,12,5,112,48,0,8,168
Boston,12,6,151,52,1,15,219
Boston,12,7,240,120,3,15,378
Boston,12,8,87,40,0,4,131
Boston,12,9,136,64,2,6,208
Boston,13,1,155,97,1,15,268
Boston,13,2,39,38,1,3,81
Boston,13,3,81,35,1,3,120
Boston,13,4,115,69,0,6,190
Boston,13,5,121,39,4,13,177
Boston,13,6,178,50,0,6,234
Boston,13,7,143,48,4,13,208
Boston,13,8,140,40,1,8,189
Boston,13,9,188,33,0,6,227
Boston,13,10,369,65,3,28,465
Boston,14,1,238,130,2,12,382
Boston,14,2,239,92,1,14,346
Boston,14,3,120,54,1,13,188
Boston,14,4,150,65,1,8,224
Boston,14,5,110,44,0,8,162
Boston,14,6,104,50,1,5,160
Boston,14,7,126,73,0,6,205
Boston,14,8,189,75,1,10,275
Boston,14,9,101,42,0,2,145
Boston,14,10,121,63,0,8,192
Boston,14,11,120,59,1,4,184
Boston,14,12,79,32,0,10,121
Boston,14,13,146,36,0,3,185
Boston,14,14,158,54,1,8,221
Boston,15,1,162,66,0,13,241
Boston,15,2,90,26,1,6,123
Boston,15,3,66,24,1,3,94
Boston,15,4,150,63,0,24,237
Boston,15,5,120,41,1,12,174
Boston,15,6,88,38,1,8,135
Boston,15,7,116,33,0,8,157
Boston,15,8,81,30,0,3,114
Boston,15,9,99,26,1,4,130
Boston,16,1,117,47,2,6,172
Boston,16,2,130,32,1,8,171
Boston,16,3,175,64,0,6,245
Boston,16,4,164,43,0,8,215
Boston,16,5,199,34,2,8,243
Boston,16,6,233,58,2,13,306
Boston,16,7,219,48,4,31,302
Boston,16,8,419,79,4,41,543
Boston,16,9,269,42,7,66,384
Boston,16,10,198,46,3,28,275
Boston,16,11,181,42,1,28,252
Boston,16,12,307,53,7,91,458
Boston,17,1,150,44,0,5,199
Boston,17,2,97,36,0,4,137
Boston,17,3,296,74,0,12,382
Boston,17,4,379,69,2,19,469
Boston,17,5,85,25,2,9,121
Boston,17,6,222,51,1,7,281
Boston,17,7,94,52,0,2,148
Boston,17,8,167,37,0,2,206
Boston,17,9,247,61,1,8,317
Boston,17,10,198,45,0,4,247
Boston,17,11,96,22,1,2,121
Boston,17,12,191,43,1,7,242
Boston,17,13,290,58,0,15,363
Boston,17,14,299,64,0,17,380
Boston,18,1,343,118,1,16,478
Boston,18,2,204,64,2,19,289
Boston,18,3,287,86,1,14,388
Boston,18,4,292,78,0,25,395
Boston,18,5,337,87,3,14,441
Boston,18,6,426,101,3,23,553
Boston,18,7,224,88,1,11,324
Boston,18,8,375,157,2,27,561
Boston,18,9,340,68,6,18,432
Boston,18,10,534,88,2,20,644
Boston,18,11,167,66,0,7,240
Boston,18,12,292,70,3,17,382
Boston,18,13,166,33,1,11,211
Boston,18,14,125,47,0,5,177
Boston,18,15,250,80,1,17,348
Boston,18,16,362,80,2,47,491
Boston,18,17,241,73,1,18,333
Boston,18,18,279,108,4,30,421
Boston,18,19,393,98,4,33,528
Boston,18,20,334,99,1,44,478
Boston,18,21,347,101,0,15,463
Boston,18,22,354,93,4,23,474
Boston,18,23,113,60,0,5,178
Boston,19,1,317,126,1,13,457
Boston,19,2,495,86,2,18,601
Boston,19,3,264,49,0,6,319
Boston,19,4,484,155,0,14,653
Boston,19,5,365,90,3,10,468
Boston,19,6,525,113,1,10,649
Boston,19,7,352,134,0,7,493
Boston,19,8,361,72,1,10,444
Boston,19,9,242,65,0,5,312
Boston,19,10,438,97,0,11,546
Boston,19,11,185,49,1,6,241
Boston,19,12,351,91,1,11,454
Boston,19,13,215,52,1,11,279
Boston,20,1,397,86,3,31,517
Boston,20,2,385,73,0,10,468
Boston,20,3,226,51,1,16,294
Boston,20,4,434,66,1,17,518
Boston,20,5,319,54,5,45,423
Boston,20,6,493,56,4,39,592
Boston,20,7,308,36,2,22,368
Boston,20,8,348,39,2,10,399
Boston,20,9,329,67,2,14,412
Boston,20,10,440,72,3,45,560
Boston,20,11,243,42,2,22,309
Boston,20,12,329,38,2,23,392
Boston,20,13,272,36,6,41,355
Boston,20,14,271,52,4,29,356
Boston,20,15,316,52,7,38,413
Boston,20,16,346,71,8,44,469
Boston,20,17,482,49,0,63,594
Boston,20,18,264,33,4,29,330
Boston,20,19,259,36,0,37,332
Boston,20,20,390,40,1,31,462
Boston,20,21,25,12,0,1,38
Boston,21,1,186,42,0,7,235
Boston,21,2,32,6,0,2,40
Boston,21,3,77,32,0,5,114
Boston,21,4,72,16,0,3,91
Boston,21,5,141,55,0,8,204
Boston,21,6,184,35,0,5,224
Boston,21,7,113,53,0,5,171
Boston,21,8,191,70,0,3,264
Boston,21,9,188,58,1,2,249
Boston,21,10,170,48,0,5,223
Boston,21,11,207,50,0,7,264
Boston,21,12,227,29,3,7,266
Boston,21,13,274,72,0,5,351
Boston,21,14,129,28,0,2,159
Boston,21,15,147,49,1,4,201
Boston,21,16,293,40,1,5,339
Boston,22,1,197,68,0,9,274
Boston,22,2,260,84,0,13,357
Boston,22,3,220,62,1,12,295
Boston,22,4,217,59,2,5,283
Boston,22,5,149,39,0,9,197
Boston,22,6,132,36,0,5,173
Boston,22,7,205,58,2,11,276
Boston,22,8,163,24,1,9,197
Boston,22,9,194,37,1,10,242
Boston,22,10,233,40,2,14,289
Boston,22,11,155,26,1,9,191
Boston,22,12,158,36,4,8,206
Boston,22,13,130,22,1,8,161
Bourne,-,1,252,29,0,7,288
Bourne,-,2,300,27,0,2,329
Bourne,-,3,123,14,0,6,143
Bourne,-,4,430,28,0,9,467
Bourne,-,5,309,37,1,4,351
Bourne,-,5A,57,4,0,0,61
Bourne,-,6,326,24,1,13,364
Bourne,-,7,242,27,1,2,272
Boxborough,-,1,691,75,1,9,776
Boxford,-,1,268,28,1,4,301
Boxford,-,2,320,41,0,7,368
Boxford,-,3,292,31,0,6,329
Boylston,-,1,600,81,1,19,701
Braintree,-,1A,309,48,1,9,367
Braintree,-,1B,204,38,3,14,259
Braintree,-,2A,319,46,5,11,381
Braintree,-,2B,323,42,2,8,375
Braintree,-,3A,284,44,1,14,343
Braintree,-,3B,301,48,2,7,358
Braintree,-,4A,262,36,2,5,305
Braintree,-,4B,257,40,0,6,303
Braintree,-,5A,287,48,3,10,348
Braintree,-,5B,300,71,5,18,394
Braintree,-,6A,321,43,0,9,373
Braintree,-,6B,295,43,3,22,363
Brewster,-,1,664,64,0,9,737
Brewster,-,2,633,52,0,7,692
Brewster,-,3,581,57,0,9,647
Bridgewater,-,1,246,32,1,3,282
Bridgewater,-,2,261,44,1,4,310
Bridgewater,-,3,349,35,1,5,390
Bridgewater,-,4,149,27,1,4,181
Bridgewater,-,5,34,3,0,1,38
Bridgewater,-,6,130,33,1,4,168
Bridgewater,-,7,229,26,0,3,258
Bridgewater,-,8,239,33,0,5,277
Bridgewater,-,9,218,29,0,7,254
Brimfield,-,1,214,33,0,108,355
Brockton,1,A,160,44,0,23,227
Brockton,1,B,292,71,1,18,382
Brockton,1,C,196,42,0,6,244
Brockton,1,D,324,63,0,20,407
Brockton,2,A,99,47,0,25,171
Brockton,2,B,133,63,1,26,223
Brockton,2,C,85,35,0,16,136
Brockton,2,D,185,56,0,13,254
Brockton,3,A,184,69,0,13,266
Brockton,3,B,96,63,0,7,166
Brockton,3,C,279,50,1,20,350
Brockton,3,D,306,54,0,9,369
Brockton,4,A,55,29,0,2,86
Brockton,4,B,148,49,1,7,205
Brockton,4,C,216,63,0,12,291
Brockton,4,D,212,67,3,26,308
Brockton,5,A,93,62,1,11,167
Brockton,5,B,231,54,1,9,295
Brockton,5,C,126,41,1,12,180
Brockton,5,D,273,71,0,25,369
Brockton,6,A,169,38,0,12,219
Brockton,6,B,239,54,0,10,303
Brockton,6,C,206,48,0,14,268
Brockton,6,D,281,60,0,8,349
Brockton,7,A,140,49,0,25,214
Brockton,7,B,234,86,0,41,361
Brockton,7,C,218,95,0,20,333
Brockton,7,D,226,84,0,18,328
Brookfield,-,1,234,41,1,2,278
Brookline,-,1,467,49,0,24,540
Brookline,-,2,273,51,1,11,336
Brookline,-,3,556,67,1,16,640
Brookline,-,4,395,67,1,15,478
Brookline,-,5,255,26,1,5,287
Brookline,-,5A,325,51,0,12,388
Brookline,-,6,746,93,3,24,866
Brookline,-,7,486,98,1,14,599
Brookline,-,8,559,83,0,19,661
Brookline,-,9,597,72,0,21,690
Brookline,-,10,583,69,0,22,674
Brookline,-,11,613,68,0,11,692
Brookline,-,12,638,66,2,24,730
Brookline,-,13,422,37,0,8,467
Brookline,-,13A,83,13,0,5,101
Brookline,-,14,390,50,0,13,453
Brookline,-,14A,115,7,0,2,124
Brookline,-,15,493,60,1,14,568
Brookline,-,16,477,47,0,14,538
Brookline,-,17,474,68,0,45,587
Buckland,-,1,304,36,0,7,347
Burlington,-,1,432,65,2,13,512
Burlington,-,2,253,43,1,11,308
Burlington,-,3,416,84,1,11,512
Burlington,-,4,312,28,2,4,346
Burlington,-,5,428,89,4,28,549
Burlington,-,6,392,71,0,25,488
Burlington,-,7,395,68,0,6,469
Cambridge,1,1,171,41,0,2,214
Cambridge,1,2,105,11,0,3,119
Cambridge,1,2A,1,0,0,0,1
Cambridge,1,3,321,76,2,15,414
Cambridge,2,1,338,85,0,11,434
Cambridge,2,2,376,70,1,14,461
Cambridge,2,3,287,43,0,3,333
Cambridge,2,3A,31,5,0,0,36
Cambridge,3,1,191,89,0,13,293
Cambridge,3,2,322,83,0,8,413
Cambridge,3,3,216,79,0,4,299
Cambridge,3,3A,131,18,0,2,151
Cambridge,4,1,560,105,1,11,677
Cambridge,4,2,389,74,1,10,474
Cambridge,4,2A,63,11,0,0,74
Cambridge,4,3,417,93,0,8,518
Cambridge,5,1,385,79,0,21,485
Cambridge,5,2,26,7,0,0,33
Cambridge,5,3,380,79,1,2,462
Cambridge,6,1,379,67,2,4,452
Cambridge,6,1A,148,22,0,5,175
Cambridge,6,2,266,34,0,4,304
Cambridge,6,3,572,93,0,8,673
Cambridge,7,1,487,77,0,14,578
Cambridge,7,2,313,42,0,5,360
Cambridge,7,2A,16,0,0,0,16
Cambridge,7,3,116,19,0,2,137
Cambridge,8,1,462,70,0,17,549
Cambridge,8,2,481,49,0,11,541
Cambridge,8,3,78,24,0,2,104
Cambridge,9,1,892,60,0,10,962
Cambridge,9,2,611,86,0,9,706
Cambridge,9,3,564,81,1,7,653
Cambridge,10,1,424,88,0,9,521
Cambridge,10,1A,266,37,1,10,314
Cambridge,10,2,817,78,0,16,911
Cambridge,10,3,477,95,0,12,584
Cambridge,11,1,115,28,0,5,148
Cambridge,11,1A,169,37,0,3,209
Cambridge,11,2,245,74,1,5,325
Cambridge,11,3,497,119,3,9,628
Cambridge,11,3A,79,10,0,3,92
Canton,-,1,335,45,1,22,403
Canton,-,2,515,62,0,20,597
Canton,-,3,230,40,0,13,283
Canton,-,4,391,56,2,24,473
Canton,-,5,450,65,1,21,537
Canton,-,6,375,66,1,15,457
Canton,-,7,434,43,0,20,497
Carlisle,-,1,1066,105,0,34,1205
Carver,-,1,248,29,0,3,280
Carver,-,2,244,31,0,6,281
Carver,-,3,323,47,0,5,375
Charlemont,-,1,139,15,0,4,158
Charlton,-,1,233,41,0,5,279
Charlton,-,2,209,32,1,2,244
Charlton,-,3,207,41,0,2,250
Charlton,-,4,224,41,0,4,269
Charlton,-,4A,8,0,0,0,8
Chatham,-,1,538,59,0,7,604
Chatham,-,2,496,40,0,7,543
Chelmsford,-,1,337,58,0,19,414
Chelmsford,-,2,389,50,0,14,453
Chelmsford,-,3A,161,28,0,7,196
Chelmsford,-,3B,187,34,0,4,225
Chelmsford,-,4,419,49,0,7,475
Chelmsford,-,5A,345,41,0,5,391
Chelmsford,-,5B,112,10,0,2,124
Chelmsford,-,6,416,50,2,11,479
Chelmsford,-,7,364,57,0,7,428
Chelmsford,-,8,464,60,0,16,540
Chelmsford,-,9,466,74,1,19,560
Chelmsford,-,10,289,73,0,11,373
Chelmsford,-,11,446,67,1,20,534
Chelsea,1,1,58,45,0,9,112
Chelsea,1,2,30,36,0,14,80
Chelsea,1,3,70,47,0,9,126
Chelsea,1,4,45,38,0,9,92
Chelsea,2,1,278,59,0,33,370
Chelsea,2,2,67,55,0,7,129
Chelsea,2,3,40,29,0,12,81
Chelsea,2,4,77,58,0,3,138
Chelsea,3,1,87,66,0,12,165
Chelsea,3,2,113,55,0,14,182
Chelsea,3,3,74,60,0,16,150
Chelsea,3,4,67,73,0,18,158
Chelsea,4,1,107,44,0,6,157
Chelsea,4,2,122,58,0,30,210
Chelsea,4,3,132,72,0,16,220
Chelsea,4,4,101,53,0,11,165
Cheshire,-,1,438,128,2,63,631
Chester,-,1,72,17,0,4,93
Chesterfield,-,1,170,35,0,4,209
Chicopee,1,A,292,86,2,14,394
Chicopee,1,B,391,85,2,20,498
Chicopee,2,A,142,31,1,4,178
Chicopee,2,B,255,64,1,14,334
Chicopee,3,A,144,41,1,2,188
Chicopee,3,A1,30,9,0,0,39
Chicopee,3,B,127,56,1,4,188
Chicopee,4,A,198,57,0,11,266
Chicopee,4,B,211,44,4,7,266
Chicopee,5,A,248,67,1,12,328
Chicopee,5,B,222,70,3,12,307
Chicopee,6,AN,126,18,5,3,152
Chicopee,6,AS,211,43,1,12,267
Chicopee,6,BE,284,72,2,26,384
Chicopee,6,BW,51,14,0,3,68
Chicopee,7,A,152,53,0,5,210
Chicopee,7,B,167,48,0,8,223
Chicopee,8,A,265,67,1,20,353
Chicopee,8,B,210,58,13,0,281
Chicopee,9,A,264,80,6,13,363
Chicopee,9,B,342,79,1,14,436
Chilmark,-,1,327,30,0,8,365
Clarksburg,-,1,208,51,0,17,276
Clinton,-,1,308,55,1,4,368
Clinton,-,2,189,55,0,2,246
Clinton,-,3,288,49,0,8,345
Clinton,-,4,220,45,1,4,270
Cohasset,-,1,302,28,2,9,341
Cohasset,-,2,297,23,0,2,322
Cohasset,-,3,302,24,1,7,334
Colrain,-,1,210,21,0,2,233
Concord,-,1,715,79,0,33,827
Concord,-,2,847,81,0,19,947
Concord,-,3,781,59,0,14,854
Concord,-,4,729,90,1,21,841
Concord,-,5,833,70,0,23,926
Conway,-,1,353,29,1,6,389
Cummington,-,1,149,22,0,2,173
Dalton,-,1,501,112,5,70,688
Dalton,-,2,491,131,0,69,691
Danvers,-,1,384,51,1,18,454
Danvers,-,2,421,39,1,17,478
Danvers,-,3,330,44,2,9,385
Danvers,-,4,414,49,0,15,478
Danvers,-,5,392,48,1,17,458
Danvers,-,6,399,59,1,20,479
Danvers,-,7,381,58,2,13,454
Danvers,-,8,324,50,0,13,387
Dartmouth,-,1,261,66,0,14,341
Dartmouth,-,2,242,75,2,8,327
Dartmouth,-,3,37,7,0,2,46
Dartmouth,-,4,353,46,1,14,414
Dartmouth,-,5,433,75,1,20,529
Dartmouth,-,6,260,85,2,19,366
Dartmouth,-,7,406,106,0,35,547
Dartmouth,-,8,760,88,2,36,886
Dartmouth,-,9,639,99,4,43,785
Dedham,-,1,519,31,2,17,569
Dedham,-,2,455,62,1,16,534
Dedham,-,3,324,57,1,11,393
Dedham,-,4,384,41,0,12,437
Dedham,-,5,376,53,1,19,449
Dedham,-,6,429,61,1,13,504
Dedham,-,7,414,52,3,24,493
Deerfield,-,1,742,67,0,12,821
Dennis,-,1,540,32,2,12,586
Dennis,-,2,607,51,0,8,666
Dennis,-,3,301,23,1,4,329
Dennis,-,4,445,50,3,9,507
Dennis,-,5,365,42,0,5,412
Dighton,-,1,164,32,1,6,203
Dighton,-,2,164,28,1,9,202
Dighton,-,3,136,44,1,9,190
Douglas,-,1,131,31,0,4,166
Douglas,-,2,165,28,0,6,199
Douglas,-,3,145,22,0,1,168
Dover,-,1,602,64,5,19,690
Dracut,-,1,244,34,0,8,286
Dracut,-,2,217,52,0,8,277
Dracut,-,3,229,44,0,10,283
Dracut,-,4,252,48,0,8,308
Dracut,-,5,208,48,0,10,266
Dracut,-,6,269,42,0,15,326
Dracut,-,6A,22,6,0,1,29
Dracut,-,7,201,48,0,6,255
Dracut,-,8,277,48,0,6,331
Dracut,-,9,247,42,0,5,294
Dudley,-,1,232,33,0,3,268
Dudley,-,2,146,25,0,1,172
Dudley,-,3,163,31,0,2,196
Dudley,-,4,211,32,0,3,246
Dunstable,-,1,345,36,3,2,386
Duxbury,-,1,378,30,1,12,421
Duxbury,-,2,263,17,0,5,285
Duxbury,-,3,282,18,0,4,304
Duxbury,-,4,242,19,0,6,267
Duxbury,-,5,288,18,0,5,311
Duxbury,-,6,252,16,1,7,276
E. Bridgewater,-,1,217,36,0,9,262
E. Bridgewater,-,2,226,33,1,3,263
E. Bridgewater,-,3,316,32,2,5,355
E. Bridgewater,-,4,242,34,2,6,284
E. Brookfield,-,1,138,22,0,4,164
E. Longmeadow,-,1,357,56,2,22,437
E. Longmeadow,-,2,270,53,2,12,337
E. Longmeadow,-,2A,6,2,0,0,8
E. Longmeadow,-,3,317,57,1,21,396
E. Longmeadow,-,3A,17,3,0,2,22
E. Longmeadow,-,4,256,36,0,13,305
E. Longmeadow,-,4A,43,7,0,4,54
E. Longmeadow,-,5,339,42,0,18,399
Eastham,-,1,1180,114,0,24,1318
Easthampton,-,1,549,70,5,18,642
Easthampton,-,2,450,102,3,10,565
Easthampton,-,3,546,106,0,20,672
Easthampton,-,4,591,92,0,17,700
Easthampton,-,5,485,72,3,15,575
Easton,-,1,424,55,3,11,493
Easton,-,2,370,49,1,11,431
Easton,-,3,180,19,0,2,201
Easton,-,4A,178,27,0,9,214
Easton,-,4B,189,24,1,2,216
Easton,-,5,372,45,0,9,426
Easton,-,6,296,36,0,7,339
Easton,-,7,343,51,1,3,398
Edgartown,-,1,609,98,1,32,740
Egremont,-,1,308,60,0,19,387
Erving,-,1,146,24,1,1,172
Essex,-,1,450,45,0,6,501
Everett,1,1,136,27,2,14,179
Everett,1,2,74,18,0,13,105
Everett,1,3,42,17,0,5,64
Everett,1,3A,38,21,0,3,62
Everett,2,1,157,49,1,10,217
Everett,2,2,57,22,1,5,85
Everett,2,2A,49,22,0,6,77
Everett,2,3,101,27,1,13,142
Everett,3,1,198,53,0,28,279
Everett,3,2,127,39,1,12,179
Everett,3,3,80,15,1,16,112
Everett,4,1,154,46,2,15,217
Everett,4,2,143,59,1,37,240
Everett,4,3,114,35,2,10,161
Everett,5,1,136,34,1,9,180
Everett,5,2,141,20,0,18,179
Everett,5,3,98,34,2,15,149
Everett,6,1,128,43,0,14,185
Everett,6,2,97,28,1,15,141
Everett,6,3,144,39,1,12,196
Fairhaven,-,1,379,71,1,15,466
Fairhaven,-,2,318,65,1,29,413
Fairhaven,-,3,197,51,1,9,258
Fairhaven,-,4,304,57,1,17,379
Fairhaven,-,5,324,63,0,17,404
Fairhaven,-,6,268,64,1,19,352
Fall River,1,A,223,73,1,20,317
Fall River,1,B,105,50,2,14,171
Fall River,1,C,121,40,2,97,260
Fall River,2,A,73,34,0,5,112
Fall River,2,B,69,25,0,6,100
Fall River,2,C,89,36,1,9,135
Fall River,3,A,165,45,1,18,229
Fall River,3,B,144,48,0,13,205
Fall River,3,C,156,48,1,7,212
Fall River,4,A,116,35,1,8,160
Fall River,4,B,66,21,2,10,99
Fall River,4,C,171,59,6,0,236
Fall River,5,A,57,31,0,2,90
Fall River,5,B,85,32,0,2,119
Fall River,5,C,59,39,0,3,101
Fall River,6,A,137,64,1,10,212
Fall River,6,B,131,46,0,7,184
Fall River,6,C,115,49,0,15,179
Fall River,7,A,210,48,0,19,277
Fall River,7,B,102,33,0,7,142
Fall River,7,C,144,59,0,58,261
Fall River,8,A,137,31,0,19,187
Fall River,8,B,297,58,1,36,392
Fall River,8,C,276,73,1,29,379
Fall River,9,A,413,89,2,47,551
Fall River,9,B,258,76,1,34,369
Fall River,9,C,198,51,0,24,273
Falmouth,-,1,895,71,1,21,988
Falmouth,-,2,661,72,0,12,745
Falmouth,-,3,543,61,0,10,614
Falmouth,-,4,516,49,0,9,574
Falmouth,-,5,670,43,4,14,731
Falmouth,-,6,591,66,1,14,672
Falmouth,-,7,446,58,1,9,514
Falmouth,-,8,425,36,0,7,468
Falmouth,-,9,409,39,1,10,459
Fitchburg,1,A,117,29,1,3,150
Fitchburg,1,B,167,35,1,7,210
Fitchburg,2,A,107,27,0,2,136
Fitchburg,2,B,153,34,1,3,191
Fitchburg,3,A,315,45,0,1,361
Fitchburg,3,B,177,46,0,5,228
Fitchburg,4,A,126,26,0,5,157
Fitchburg,4,B,130,36,0,3,169
Fitchburg,5,A,315,40,1,5,361
Fitchburg,5,B,83,27,0,2,112
Fitchburg,6,A,205,30,0,5,240
Fitchburg,6,B,113,35,0,0,148
Florida,-,1,72,18,0,5,95
Foxborough,-,1,282,34,0,2,318
Foxborough,-,2,395,42,0,11,448
Foxborough,-,3,318,24,1,5,348
Foxborough,-,4,319,47,1,3,370
Foxborough,-,5,297,37,3,13,350
Framingham,-,1,67,19,2,1,89
Framingham,-,2,40,25,0,6,71
Framingham,-,3,54,30,1,2,87
Framingham,-,4,104,23,0,5,132
Framingham,-,5,220,52,0,4,276
Framingham,-,6,318,52,2,10,382
Framingham,-,7,383,52,1,16,452
Framingham,-,8,197,23,1,4,225
Framingham,-,9A,263,34,1,3,301
Framingham,-,9B,8,3,0,0,11
Framingham,-,10,187,28,0,6,221
Framingham,-,11,250,41,0,14,305
Framingham,-,12,238,53,0,7,298
Framingham,-,13,100,29,1,1,131
Framingham,-,14,139,23,2,1,165
Framingham,-,15,146,26,0,5,177
Framingham,-,16,292,42,1,7,342
Framingham,-,17,353,38,1,7,399
Framingham,-,18,361,46,0,7,414
Framingham,-,19,367,28,0,3,398
Framingham,-,20,388,40,1,11,440
Framingham,-,21A,302,26,0,2,330
Framingham,-,21B,176,19,0,3,198
Framingham,-,21C,8,0,0,0,8
Framingham,-,22,453,39,0,10,502
Framingham,-,23,329,29,0,7,365
Framingham,-,24,364,35,0,4,403
Framingham,-,25,358,45,1,3,407
Framingham,-,26,313,43,1,3,360
Framingham,-,27,326,35,0,3,364
Franklin,-,1,339,51,0,3,393
Franklin,-,2,313,54,0,10,377
Franklin,-,3,361,51,1,7,420
Franklin,-,4,372,37,2,5,416
Franklin,-,5,347,57,1,4,409
Franklin,-,6,335,55,2,8,400
Franklin,-,7,364,47,1,4,416
Franklin,-,8,327,36,2,5,370
Franklin,-,9,269,40,1,6,316
Freetown,-,1,220,48,1,13,282
Freetown,-,2,254,45,2,8,309
Freetown,-,3,199,31,1,8,239
Gardner,1,A,206,35,1,5,247
Gardner,1,B,72,21,0,0,93
Gardner,2,A,147,19,0,3,169
Gardner,2,B,127,16,0,1,144
Gardner,3,A,104,20,0,3,127
Gardner,3,B,150,37,0,4,191
Gardner,4,A,151,34,0,1,186
Gardner,4,B,92,20,2,1,115
Gardner,5,A,110,24,1,2,137
Gardner,5,B,183,28,1,4,216
Georgetown,-,1,325,28,1,7,361
Georgetown,-,2,261,30,2,3,296
Georgetown,-,3,265,31,0,6,302
Gill,-,1,205,34,0,1,240
Gloucester,1,1,563,46,1,11,621
Gloucester,1,2,370,42,1,4,417
Gloucester,2,1,257,33,0,8,298
Gloucester,2,2,268,45,0,3,316
Gloucester,3,1,265,28,0,6,299
Gloucester,3,2,314,28,0,7,349
Gloucester,4,1,377,46,1,5,429
Gloucester,4,2,665,44,1,17,727
Gloucester,5,1,466,33,2,12,513
Gloucester,5,2,461,37,1,9,508
Goshen,-,1,165,24,0,2,191
Gosnold,-,1,14,3,0,0,17
Grafton,-,1,250,35,1,3,289
Grafton,-,2,300,47,0,4,351
Grafton,-,3,291,37,1,6,335
Grafton,-,4,224,41,0,2,267
Grafton,-,5,348,36,0,4,388
Granby,-,1,318,70,0,9,397
Granby,-,2,253,46,1,5,305
Granby,-,2A,5,0,0,0,5
Granville,-,1,79,17,0,4,100
Great Barrington,-,A,295,64,1,13,373
Great Barrington,-,B,289,63,0,22,374
Great Barrington,-,C,204,56,0,17,277
Great Barrington,-,D,287,56,2,19,364
Greenfield,-,1,228,30,0,6,264
Greenfield,-,2,321,35,0,3,359
Greenfield,-,3,264,34,0,7,305
Greenfield,-,4,253,31,0,7,291
Greenfield,-,5,296,42,0,9,347
Greenfield,-,6,232,48,0,9,289
Greenfield,-,7,179,22,0,6,207
Greenfield,-,8,158,30,0,5,193
Greenfield,-,9,129,20,0,4,153
Groton,-,1,452,48,0,8,508
Groton,-,2,386,42,0,8,436
Groton,-,3,443,39,0,10,492
Groton,-,3A,36,5,1,2,44
Groveland,-,1,342,36,0,4,382
Groveland,-,2,359,32,0,11,402
Hadley,-,1,738,112,0,25,875
Halifax,-,1,265,33,1,3,302
Halifax,-,2,281,35,0,4,320
Halifax,-,2A,10,0,0,0,10
Hamilton,-,1,469,53,0,21,543
Hamilton,-,2,438,50,0,9,497
Hampden,-,1,419,65,0,13,497
Hancock,-,1,78,32,0,13,123
Hanover,-,1,378,52,2,11,443
Hanover,-,2,331,44,2,9,386
Hanover,-,3,328,34,0,14,376
Hanover,-,4,333,31,0,10,374
Hanson,-,1,308,37,0,2,347
Hanson,-,2,321,35,4,7,367
Hanson,-,3,251,25,0,1,277
Hardwick,-,1,204,46,0,4,254
Harvard,-,1,948,84,0,13,1045
Harwich,-,1,658,55,1,8,722
Harwich,-,2,541,50,0,12,603
Harwich,-,3,514,49,1,10,574
Harwich,-,4,442,54,1,7,504
Hatfield,-,1,537,121,0,24,682
Haverhill,1,1,53,36,0,3,92
Haverhill,1,2,82,47,0,6,135
Haverhill,1,2A,46,6,0,3,55
Haverhill,1,3,82,18,0,2,102
Haverhill,1,3A,71,23,0,6,100
Haverhill,2,1,279,45,2,7,333
Haverhill,2,2,254,39,1,8,302
Haverhill,2,3,107,43,0,5,155
Haverhill,3,1,139,73,0,8,220
Haverhill,3,2,149,47,1,4,201
Haverhill,3,3,140,29,0,3,172
Haverhill,4,1,299,47,2,8,356
Haverhill,4,2,392,61,2,15,470
Haverhill,4,3,298,45,0,9,352
Haverhill,5,1,167,23,0,4,194
Haverhill,5,1A,39,8,0,0,47
Haverhill,5,2,287,30,0,14,331
Haverhill,5,3,309,33,1,9,352
Haverhill,5,3A,16,2,0,0,18
Haverhill,6,1,180,42,1,2,225
Haverhill,6,2,197,34,0,8,239
Haverhill,6,2A,83,20,0,1,104
Haverhill,6,3,329,40,0,8,377
Haverhill,7,1,268,57,0,4,329
Haverhill,7,2,153,28,1,4,186
Haverhill,7,2A,132,36,1,8,177
Haverhill,7,3,325,38,1,12,376
Haverhill,7,3A,6,1,0,1,8
Hawley,-,1,52,8,0,1,61
Heath,-,1,99,12,0,2,113
Hingham,-,1,376,31,0,8,415
Hingham,-,2,396,41,0,10,447
Hingham,-,3,357,43,0,8,408
Hingham,-,4,373,35,1,5,414
Hingham,-,5,314,37,0,6,357
Hingham,-,6,324,41,1,5,371
Hingham,-,7,239,37,2,10,288
Hingham,-,7A,534,29,0,15,578
Hinsdale,-,1,294,63,0,28,385
Holbrook,-,1,219,41,0,6,266
Holbrook,-,2,219,34,1,7,261
Holbrook,-,3,224,28,0,3,255
Holbrook,-,4,215,39,3,6,263
Holden,-,1,312,45,0,5,362
Holden,-,2,341,36,0,10,387
Holden,-,3,354,36,0,10,400
Holden,-,4,326,57,0,6,389
Holden,-,5,341,52,0,10,403
Holden,-,6,311,50,1,13,375
Holland,-,1,159,17,0,3,179
Holliston,-,1,463,78,3,14,558
Holliston,-,2,505,56,0,10,571
Holliston,-,3,403,32,0,13,448
Holliston,-,4,496,36,0,15,547
Holyoke,1,A,39,33,0,0,72
Holyoke,1,B,81,64,0,3,148
Holyoke,2,A,131,27,1,6,165
Holyoke,2,B,30,31,0,2,63
Holyoke,3,A,190,59,0,4,253
Holyoke,3,B,273,49,2,20,344
Holyoke,4,A,51,36,0,2,89
Holyoke,4,B,107,58,0,2,167
Holyoke,5,A,349,65,1,29,444
Holyoke,5,B,188,55,0,9,252
Holyoke,6,A,178,46,0,13,237
Holyoke,6,B,222,67,0,14,303
Holyoke,7,A,434,92,1,28,555
Holyoke,7,B,335,60,2,26,423
Hopedale,-,1,452,63,0,7,522
Hopkinton,-,1,262,30,0,5,297
Hopkinton,-,2,369,55,1,9,434
Hopkinton,-,3,347,54,0,7,408
Hopkinton,-,4,351,44,1,6,402
Hopkinton,-,5,389,52,0,7,448
Hubbardston,-,1,326,53,2,5,386
Hudson,-,1,298,39,0,5,342
Hudson,-,2,217,49,1,4,271
Hudson,-,3,333,35,1,6,375
Hudson,-,4,408,50,2,2,462
Hudson,-,5,476,51,0,6,533
Hudson,-,6,226,29,0,3,258
Hull,-,1,568,57,0,11,636
Hull,-,2,400,61,1,9,471
Hull,-,3,580,74,1,19,674
Huntington,-,1,165,37,0,3,205
Ipswich,-,1,485,58,1,10,554
Ipswich,-,2,521,50,0,6,577
Ipswich,-,3,435,48,0,12,495
Ipswich,-,4,474,54,0,11,539
Kingston,-,1,256,35,0,7,298
Kingston,-,2,285,33,1,3,322
Kingston,-,3,278,38,2,4,322
Kingston,-,4,278,42,1,1,322
Lakeville,-,1,237,40,0,9,286
Lakeville,-,2,268,44,0,6,318
Lakeville,-,3,235,40,0,5,280
Lancaster,-,1,217,37,0,5,259
Lancaster,-,2,379,41,0,6,426
Lanesborough,-,1,441,96,2,77,616
Lawrence,A,1,129,89,2,10,230
Lawrence,A,2,81,72,0,25,178
Lawrence,A,2A,0,1,0,1,2
Lawrence,A,3,90,78,0,12,180
Lawrence,A,4,114,94,0,20,228
Lawrence,B,1,193,100,0,54,347
Lawrence,B,2,78,75,2,27,182
Lawrence,B,3,74,84,1,28,187
Lawrence,B,4,137,106,0,77,320
Lawrence,C,1,81,69,0,10,160
Lawrence,C,2,123,64,4,11,202
Lawrence,C,3,53,77,1,19,150
Lawrence,C,4,78,76,0,22,176
Lawrence,D,1,101,83,2,11,197
Lawrence,D,2,80,72,2,19,173
Lawrence,D,3,46,57,1,15,119
Lawrence,D,4,97,102,1,23,223
Lawrence,E,1,195,73,1,18,287
Lawrence,E,1A,3,3,0,2,8
Lawrence,E,2,227,92,3,16,338
Lawrence,E,3,137,80,2,22,241
Lawrence,E,4,138,87,1,16,242
Lawrence,F,1,200,74,0,24,298
Lawrence,F,2,95,98,3,35,231
Lawrence,F,3,110,60,0,9,179
Lawrence,F,4,101,72,3,19,195
Lee,-,1,813,204,2,95,1114
Leicester,-,1,188,21,0,10,219
Leicester,-,2,211,40,0,7,258
Leicester,-,3,199,37,0,5,241
Leicester,-,4,206,40,0,9,255
Lenox,-,1,1036,206,4,134,1380
Leominster,1,A,231,33,0,4,268
Leominster,1,B,232,40,2,6,280
Leominster,1,C,135,28,0,1,164
Leominster,2,A,81,27,0,0,108
Leominster,2,B,122,21,0,5,148
Leominster,2,C,56,19,0,0,75
Leominster,3,A,173,29,0,1,203
Leominster,3,B,213,41,0,4,258
Leominster,3,C,142,29,1,4,176
Leominster,4,A,233,23,1,0,257
Leominster,4,B,189,38,0,8,235
Leominster,4,C,121,17,0,2,140
Leominster,5,A,143,26,0,2,171
Leominster,5,B,163,34,0,4,201
Leominster,5,C,100,24,0,2,126
Leverett,-,1,366,34,0,5,405
Lexington,-,1,512,37,0,8,557
Lexington,-,2,621,45,1,13,680
Lexington,-,3,513,42,0,7,562
Lexington,-,4,630,63,0,11,704
Lexington,-,5,521,53,0,7,581
Lexington,-,6,609,54,0,12,675
Lexington,-,7,562,57,0,5,624
Lexington,-,8,526,42,0,11,579
Lexington,-,9,615,37,0,1,653
Leyden,-,1,114,16,0,3,133
Lincoln,-,1,825,53,1,13,892
Lincoln,-,2,428,35,1,9,473
Littleton,-,1,381,58,0,5,444
Littleton,-,2,360,39,0,4,403
Littleton,-,3,387,59,0,9,455
Longmeadow,-,A,546,63,2,31,642
Longmeadow,-,B,447,60,2,40,549
Longmeadow,-,C,406,71,1,16,494
Longmeadow,-,D,413,64,2,26,505
Longmeadow,-,E,490,58,1,33,582
Lowell,1,1,174,38,0,22,234
Lowell,1,1A,0,0,0,0,0
Lowell,1,2,174,35,0,13,222
Lowell,1,3,265,56,0,18,339
Lowell,1,4,298,61,0,37,396
Lowell,2,1,108,45,0,7,160
Lowell,2,2,148,29,0,4,181
Lowell,2,3,206,54,0,10,270
Lowell,2,4,161,44,0,12,217
Lowell,3,1,154,40,0,6,200
Lowell,3,2,525,67,0,26,618
Lowell,3,3,406,56,0,12,474
Lowell,3,4,167,31,0,5,203
Lowell,4,1,101,28,0,5,134
Lowell,4,2,209,61,0,3,273
Lowell,4,3,112,29,0,1,142
Lowell,4,3A,0,0,0,0,0
Lowell,4,4,102,26,0,12,140
Lowell,4,4A,0,0,0,0,0
Lowell,5,1,186,61,0,15,262
Lowell,5,1A,0,0,0,0,0
Lowell,5,2,107,30,0,7,144
Lowell,5,3,63,22,0,4,89
Lowell,5,4,165,22,0,3,190
Lowell,6,1,161,66,0,22,249
Lowell,6,2,95,40,0,32,167
Lowell,6,3,81,25,0,13,119
Lowell,6,3A,0,0,0,0,0
Lowell,6,4,102,52,0,25,179
Lowell,6,4A,0,0,0,0,0
Lowell,7,1,93,27,0,19,139
Lowell,7,2,60,30,0,9,99
Lowell,7,3,115,37,0,17,169
Lowell,7,4,54,23,0,15,92
Lowell,8,1,148,38,0,20,206
Lowell,8,2,136,41,0,13,190
Lowell,8,3,350,82,0,31,463
Lowell,8,4,234,56,0,22,312
Lowell,8,4A,0,0,0,0,0
Ludlow,-,1,268,58,2,16,344
Ludlow,-,2,168,59,0,11,238
Ludlow,-,3,311,76,7,15,409
Ludlow,-,4,292,68,2,32,394
Ludlow,-,5,273,48,0,12,333
Ludlow,-,6,352,70,2,24,448
Lunenburg,-,A,258,37,2,1,298
Lunenburg,-,B,251,37,0,1,289
Lunenburg,-,B1,13,2,0,0,15
Lunenburg,-,C,237,27,1,4,269
Lunenburg,-,C1,3,1,0,0,4
Lunenburg,-,D,285,37,0,2,324
Lynn,1,1,476,76,5,55,612
Lynn,1,2,330,58,4,29,421
Lynn,1,2A,58,14,0,6,78
Lynn,1,3,278,75,1,18,372
Lynn,1,4,252,56,0,16,324
Lynn,2,1,385,44,5,24,458
Lynn,2,2,142,38,2,8,190
Lynn,2,3,89,27,0,4,120
Lynn,2,4,94,36,0,1,131
Lynn,3,1,205,43,2,12,262
Lynn,3,2,103,41,1,3,148
Lynn,3,3,226,53,1,9,289
Lynn,3,4,257,73,1,8,339
Lynn,4,1,64,21,0,1,86
Lynn,4,2,56,30,0,3,89
Lynn,4,3,121,38,0,5,164
Lynn,4,3A,27,11,0,2,40
Lynn,4,4,211,58,1,17,287
Lynn,5,1,273,44,2,10,329
Lynn,5,2,60,32,0,0,92
Lynn,5,3,45,23,0,6,74
Lynn,5,4,189,80,0,18,287
Lynn,6,1,133,30,0,6,169
Lynn,6,2,40,18,0,6,64
Lynn,6,3,67,48,0,4,119
Lynn,6,4,139,48,1,8,196
Lynn,7,1,255,52,1,8,316
Lynn,7,2,258,58,0,13,329
Lynn,7,3,106,31,2,5,144
Lynn,7,4,149,35,0,4,188
Lynnfield,-,1,278,37,0,10,325
Lynnfield,-,2,322,46,2,17,387
Lynnfield,-,3,261,33,2,18,314
Lynnfield,-,4,268,41,0,18,327
Malden,1,1,140,43,0,5,188
Malden,1,2,218,35,0,13,266
Malden,1,3,224,61,1,7,293
Malden,2,1,132,37,0,5,174
Malden,2,2,129,27,2,8,166
Malden,2,3,186,46,2,10,244
Malden,3,1,118,39,0,3,160
Malden,3,1A,230,39,0,18,287
Malden,3,2,198,41,3,8,250
Malden,3,3,385,74,2,16,477
Malden,4,1,159,39,1,8,207
Malden,4,2,91,17,0,1,109
Malden,4,3,132,39,0,4,175
Malden,5,1,164,42,1,4,211
Malden,5,2,317,77,1,7,402
Malden,5,3,86,21,0,6,113
Malden,5,3A,126,26,0,4,156
Malden,6,1,284,57,0,9,350
Malden,6,2,155,30,0,2,187
Malden,6,3,189,41,0,4,234
Malden,7,1,122,42,0,10,174
Malden,7,2,131,24,2,2,159
Malden,7,3,83,22,1,5,111
Malden,7,3A,83,29,0,7,119
Malden,8,1,181,40,0,6,227
Malden,8,2,107,18,0,2,127
Malden,8,3,104,21,0,0,125
Manchester-by-the-Sea,-,1,723,67,4,17,811
Mansfield,-,1,296,37,1,1,335
Mansfield,-,2,188,25,0,4,217
Mansfield,-,2A,100,8,0,1,109
Mansfield,-,3,358,39,0,7,404
Mansfield,-,4,248,32,3,4,287
Mansfield,-,5,231,46,0,4,281
Mansfield,-,6,221,30,0,3,254
Mansfield,-,6A,35,6,0,1,42
Mansfield,-,7,289,36,2,3,330
Marblehead,-,1,788,87,1,32,908
Marblehead,-,2,664,70,0,33,767
Marblehead,-,3,562,63,3,31,659
Marblehead,-,4,666,78,0,43,787
Marblehead,-,5,607,81,2,22,712
Marblehead,-,6,705,55,0,38,798
Marion,-,1,721,100,0,24,845
Marlborough,1,1,238,49,1,8,296
Marlborough,1,1A,5,0,0,0,5
Marlborough,1,2,326,32,0,6,364
Marlborough,2,1,256,38,0,3,297
Marlborough,2,2,164,25,0,3,192
Marlborough,2,2A,2,1,0,1,4
Marlborough,3,1,93,36,0,5,134
Marlborough,3,2,257,32,2,7,298
Marlborough,4,1,90,23,0,1,114
Marlborough,4,2,259,38,0,12,309
Marlborough,5,1,133,27,1,4,165
Marlborough,5,2,247,53,0,8,308
Marlborough,6,1,110,22,0,3,135
Marlborough,6,2,295,40,0,7,342
Marlborough,7,1,197,38,0,2,237
Marlborough,7,2,190,32,1,6,229
Marlborough,7,2A,9,2,0,1,12
Marshfield,-,1,414,46,0,11,471
Marshfield,-,2,288,30,0,8,326
Marshfield,-,2A,112,18,0,1,131
Marshfield,-,3,439,47,0,9,495
Marshfield,-,4,322,40,0,8,370
Marshfield,-,5,333,53,0,8,394
Marshfield,-,6,489,48,0,15,552
Marshfield,-,7,409,42,0,7,458
Mashpee,-,1,575,47,0,8,630
Mashpee,-,2,302,47,2,5,356
Mashpee,-,3,289,46,1,5,341
Mashpee,-,4,355,44,0,5,404
Mashpee,-,5,613,66,2,12,693
Mattapoisett,-,1,572,53,0,11,636
Mattapoisett,-,2,533,50,0,17,600
Maynard,-,1,364,43,0,4,411
Maynard,-,2,303,49,0,5,357
Maynard,-,3,436,67,0,8,511
Maynard,-,4,304,34,1,1,340
Medfield,-,1,396,36,0,4,436
Medfield,-,2,326,38,1,7,372
Medfield,-,3,349,47,0,9,405
Medfield,-,4,384,32,2,12,430
Medford,1,1,365,88,0,40,493
Medford,1,2,460,90,0,37,587
Medford,2,1,409,94,0,32,535
Medford,2,2,648,141,0,83,872
Medford,3,1,608,118,0,56,782
Medford,3,2,569,87,0,26,682
Medford,4,1,169,34,0,4,207
Medford,4,2,440,98,0,17,555
Medford,5,1,299,65,0,14,378
Medford,5,2,307,87,0,8,402
Medford,6,1,568,111,0,18,697
Medford,6,2,567,76,0,13,656
Medford,6,2A,47,11,0,3,61
Medford,7,1,206,42,0,4,252
Medford,7,2,236,47,0,21,304
Medford,7,2A,32,0,0,1,33
Medford,8,1,536,115,0,48,699
Medford,8,2,321,67,0,17,405
Medway,-,1,297,32,1,4,334
Medway,-,2,323,36,1,4,364
Medway,-,3,341,51,0,7,399
Medway,-,4,310,48,1,5,364
Melrose,1,1,369,31,3,17,420
Melrose,1,2,311,27,1,5,344
Melrose,2,1,323,27,1,10,361
Melrose,2,2,342,19,2,7,370
Melrose,3,1,324,45,0,7,376
Melrose,3,2,319,36,1,6,362
Melrose,4,1,289,25,0,3,317
Melrose,4,2,309,30,2,12,353
Melrose,5,1,200,30,1,4,235
Melrose,5,2,187,31,0,2,220
Melrose,6,1,276,31,0,4,311
Melrose,6,2,342,49,1,6,398
Melrose,7,1,283,43,3,6,335
Melrose,7,2,308,38,1,9,356
Mendon,-,1,223,39,0,3,265
Mendon,-,2,213,36,0,3,252
Merrimac,-,1,321,43,1,7,372
Merrimac,-,2,376,42,1,9,428
Methuen,-,1,105,95,0,5,205
Methuen,-,2,174,73,2,11,260
Methuen,-,3,262,51,5,14,332
Methuen,-,4,239,77,3,19,338
Methuen,-,5,216,42,3,7,268
Methuen,-,6,207,46,0,7,260
Methuen,-,6A,23,8,0,1,32
Methuen,-,7,330,76,2,18,426
Methuen,-,8,296,56,1,22,375
Methuen,-,9,282,53,0,23,358
Methuen,-,10,272,41,0,16,329
Methuen,-,11,333,57,1,35,426
Methuen,-,12,254,39,1,14,308
Methuen,-,13,181,41,1,18,241
Methuen,-,13A,83,28,0,8,119
Methuen,-,14,271,93,4,16,384
Methuen,-,15,187,58,2,8,255
Middleborough,-,1,535,53,1,11,600
Middleborough,-,2,190,27,0,1,218
Middleborough,-,3,211,20,1,1,233
Middleborough,-,4,138,25,1,2,166
Middleborough,-,5,173,23,0,2,198
Middleborough,-,5A,47,7,0,0,54
Middleborough,-,6,210,34,0,2,246
Middleborough,-,7,140,28,0,4,172
Middleborough,-,7A,52,3,0,0,55
Middlefield,-,1,81,13,0,0,94
Middleton,-,1,325,58,2,18,403
Middleton,-,2,246,31,1,12,290
Middleton,-,3,231,33,1,14,279
Milford,-,1,142,29,1,1,173
Milford,-,2,249,40,1,8,298
Milford,-,3,194,37,0,5,236
Milford,-,4,142,28,0,2,172
Milford,-,5,331,67,3,5,406
Milford,-,6,264,41,1,9,315
Milford,-,7,360,40,1,3,404
Milford,-,8,337,38,0,8,383
Millbury,-,1,227,30,2,6,265
Millbury,-,2,312,41,1,12,366
Millbury,-,3,202,46,0,8,256
Millbury,-,4,237,35,4,4,280
Millis,-,1,333,46,0,5,384
Millis,-,2,286,37,1,7,331
Millis,-,3,446,36,0,8,490
Millville,-,1,135,25,0,3,163
Milton,-,1,459,71,2,9,541
Milton,-,2,556,61,1,17,635
Milton,-,3,467,59,2,28,556
Milton,-,4,268,38,0,14,320
Milton,-,4A,134,24,0,3,161
Milton,-,5,368,47,2,20,437
Milton,-,6,429,65,7,38,539
Milton,-,7,366,56,0,30,452
Milton,-,8,458,65,5,47,575
Milton,-,9,445,60,3,48,556
Milton,-,10,332,54,1,15,402
Monroe,-,1,12,4,0,0,16
Monson,-,A,256,36,2,3,297
Monson,-,B,246,42,0,7,295
Monson,-,C,238,44,0,10,292
Montague,-,1,330,53,0,7,390
Montague,-,2,144,25,2,3,174
Montague,-,3,161,24,0,4,189
Montague,-,4,168,19,2,3,192
Montague,-,5,89,28,0,2,119
Montague,-,6,120,23,0,5,148
Monterey,-,1,156,24,0,4,184
Montgomery,-,1,64,11,0,5,80
Mount Washington,-,1,35,9,0,3,47
Nahant,-,1,631,58,1,31,721
Nantucket,-,1,810,125,3,22,960
Natick,-,1,209,32,0,1,242
Natick,-,2,428,56,0,11,495
Natick,-,3,428,45,1,8,482
Natick,-,4,404,61,1,6,472
Natick,-,5,403,52,0,8,463
Natick,-,6,408,57,0,5,470
Natick,-,7,551,53,0,3,607
Natick,-,8,491,37,0,8,536
Natick,-,9,436,51,0,13,500
Natick,-,10,554,61,0,9,624
Needham,-,A,356,47,0,4,407
Needham,-,B,526,30,1,12,569
Needham,-,C,459,27,3,8,497
Needham,-,D,411,32,0,8,451
Needham,-,E,486,49,1,14,550
Needham,-,F,479,38,0,11,528
Needham,-,G,586,46,1,13,646
Needham,-,H,468,46,1,12,527
Needham,-,I,549,55,1,10,615
Needham,-,J,429,35,3,7,474
New Ashford,-,1,35,11,0,8,54
New Bedford,1,A,145,55,0,11,211
New Bedford,1,A1,10,2,0,1,13
New Bedford,1,B,201,51,0,9,261
New Bedford,1,B1,15,8,0,0,23
New Bedford,1,C,110,37,1,4,152
New Bedford,1,C1,17,5,1,0,23
New Bedford,1,D,240,49,0,10,299
New Bedford,1,E,192,55,0,4,251
New Bedford,1,F,193,73,0,11,277
New Bedford,2,A,14,12,0,1,27
New Bedford,2,B,29,30,0,4,63
New Bedford,2,C,51,29,0,3,83
New Bedford,2,D,99,38,0,5,142
New Bedford,2,E,161,42,0,8,211
New Bedford,2,F,81,33,0,3,117
New Bedford,3,A,48,22,0,1,71
New Bedford,3,B,41,31,0,1,73
New Bedford,3,C,27,19,0,3,49
New Bedford,3,D,107,31,0,5,143
New Bedford,3,E,123,40,0,10,173
New Bedford,3,F,170,41,0,9,220
New Bedford,3,F1,55,21,0,3,79
New Bedford,4,A,33,19,0,5,57
New Bedford,4,A1,45,10,0,3,58
New Bedford,4,B,134,55,1,6,196
New Bedford,4,C,140,47,0,5,192
New Bedford,4,D,116,51,0,4,171
New Bedford,4,E,99,41,0,9,149
New Bedford,4,F,118,41,1,6,166
New Bedford,5,A,89,39,0,5,133
New Bedford,5,B,253,54,0,23,330
New Bedford,5,C,154,49,1,7,211
New Bedford,5,D,266,74,0,11,351
New Bedford,5,E,290,74,0,16,380
New Bedford,5,F,277,69,2,11,359
New Bedford,6,A,185,43,2,9,239
New Bedford,6,B,125,38,0,7,170
New Bedford,6,C,59,34,0,4,97
New Bedford,6,D,46,20,1,3,70
New Bedford,6,E,46,20,1,4,71
New Bedford,6,F,88,45,1,5,139
New Braintree,-,1,98,9,0,4,111
New Marlborough,-,1,209,52,1,30,292
New Salem,-,1,149,16,1,5,171
Newbury,-,1,527,61,2,16,606
Newbury,-,2,444,45,1,8,498
Newburyport,1,1,496,31,1,15,543
Newburyport,2,1,613,51,2,10,676
Newburyport,3,1,611,34,2,10,657
Newburyport,4,1,569,25,1,16,611
Newburyport,5,1,354,33,0,19,406
Newburyport,6,1,442,42,5,14,503
Newburyport,1,P,100,7,0,3,110
Newton,1,1,199,38,0,6,243
Newton,1,2,423,38,0,13,474
Newton,1,2A,0,0,0,0,0
Newton,1,3,396,35,0,7,438
Newton,1,4,310,38,1,3,352
Newton,2,1,386,40,2,5,433
Newton,2,2,307,25,1,5,338
Newton,2,3,522,51,0,10,583
Newton,2,4,591,46,1,7,645
Newton,3,1,431,32,1,11,475
Newton,3,1A,0,0,0,0,0
Newton,3,2,489,39,1,12,541
Newton,3,3,368,52,1,3,424
Newton,3,4,390,35,1,8,434
Newton,4,1,417,37,0,11,465
Newton,4,2,472,41,2,4,519
Newton,4,3,319,40,1,1,361
Newton,4,4,362,30,1,6,399
Newton,5,1,357,35,1,7,400
Newton,5,2,500,31,1,9,541
Newton,5,3,592,38,0,10,640
Newton,5,4,492,29,1,9,531
Newton,6,1,378,34,0,3,415
Newton,6,2,485,37,2,8,532
Newton,6,3,586,37,1,7,631
Newton,6,4,585,42,0,11,638
Newton,7,1,349,25,0,12,386
Newton,7,2,514,27,5,13,559
Newton,7,3,138,13,0,2,153
Newton,7,4,219,13,1,5,238
Newton,8,1,382,27,0,6,415
Newton,8,2,320,37,0,8,365
Newton,8,3,396,33,4,6,439
Newton,8,4,355,23,0,5,383
Norfolk,-,1,188,27,0,5,220
Norfolk,-,2,373,47,1,8,429
Norfolk,-,3,296,24,2,5,327
Norfolk,-,4,284,59,2,8,353
N. Adams,1,1,263,62,0,28,353
N. Adams,2,2,278,51,0,20,349
N. Adams,3,3,178,56,0,19,253
N. Adams,4,4,306,55,0,35,396
N. Adams,5,5,228,74,0,42,344
N. Andover,-,1,312,41,1,16,370
N. Andover,-,2,400,66,2,18,486
N. Andover,-,3,374,58,1,8,441
N. Andover,-,4,537,57,2,10,606
N. Andover,-,5,185,22,0,5,212
N. Andover,-,6,405,44,0,18,467
N. Andover,-,7,333,67,2,13,415
N. Andover,-,8,358,47,0,7,412
N. Attleborough,-,1,175,30,2,2,209
N. Attleborough,-,2,231,37,1,7,276
N. Attleborough,-,3,191,27,0,9,227
N. Attleborough,-,4,221,32,2,5,260
N. Attleborough,-,5,180,41,0,6,227
N. Attleborough,-,6,273,59,0,4,336
N. Attleborough,-,7,293,43,0,8,344
N. Attleborough,-,8,235,35,0,10,280
N. Attleborough,-,9,201,30,0,1,232
N. Brookfield,-,1,404,84,2,16,506
N. Reading,-,1,349,31,2,9,391
N. Reading,-,2,372,43,1,2,418
N. Reading,-,3,324,35,1,8,368
N. Reading,-,4,361,41,1,8,411
Northampton,1,A,374,51,1,8,434
Northampton,1,B,508,69,2,4,583
Northampton,2,A,354,32,1,10,397
Northampton,2,B,275,42,0,4,321
Northampton,3,A,304,71,2,12,389
Northampton,3,B,387,67,1,3,458
Northampton,4,A,251,59,1,3,314
Northampton,4,B,466,61,0,12,539
Northampton,5,A,347,56,1,8,412
Northampton,5,B,481,63,0,8,552
Northampton,6,A,411,72,1,8,492
Northampton,6,B,533,58,0,14,605
Northampton,7,A,451,47,2,11,511
Northampton,7,B,473,58,1,19,551
Northborough,-,1,418,77,0,6,501
Northborough,-,2,436,54,0,10,500
Northborough,-,3,444,62,0,9,515
Northborough,-,4,420,72,0,12,504
Northbridge,-,1,218,33,1,3,255
Northbridge,-,2,162,26,1,3,192
Northbridge,-,3,176,28,0,5,209
Northbridge,-,4,180,39,0,2,221
Northbridge,-,5,170,33,3,0,206
Northfield,-,1,384,50,1,1,436
Norton,-,1,283,42,0,5,330
Norton,-,2,247,42,0,5,294
Norton,-,3,323,52,1,4,380
Norton,-,4,333,47,2,8,390
Norton,-,5,174,30,3,1,208
Norwell,-,1,339,40,3,3,385
Norwell,-,2,376,41,0,6,423
Norwell,-,3,375,27,0,5,407
Norwood,-,1,333,52,1,17,403
Norwood,-,2,321,35,1,11,368
Norwood,-,3,340,46,1,9,396
Norwood,-,4,402,48,1,15,466
Norwood,-,5,199,29,1,2,231
Norwood,-,6,187,39,0,6,232
Norwood,-,7,301,54,3,5,363
Norwood,-,8,357,56,1,8,422
Norwood,-,9,306,39,1,20,366
Oak Bluffs,-,1,757,130,3,41,931
Oakham,-,1,161,24,0,1,186
Orange,-,1,219,35,0,4,258
Orange,-,2,270,41,0,5,316
Orleans,-,1,645,46,0,15,706
Orleans,-,2,632,57,1,13,703
Otis,-,1,168,34,1,15,218
Oxford,-,1,192,43,1,4,240
Oxford,-,2,205,35,2,3,245
Oxford,-,3,193,29,0,5,227
Oxford,-,4,181,32,1,8,222
Oxford,-,4A,1,0,0,0,1
Palmer,-,1,223,44,0,5,272
Palmer,-,2,235,55,0,9,299
Palmer,-,3,197,31,1,4,233
Palmer,-,4,163,40,0,6,209
Paxton,-,1,399,53,0,8,460
Peabody,1,1,329,53,0,24,406
Peabody,1,2,311,41,2,19,373
Peabody,1,3,342,40,2,12,396
Peabody,2,1,178,53,2,5,238
Peabody,2,2,159,43,0,11,213
Peabody,2,3,227,42,1,12,282
Peabody,3,1,136,49,0,7,192
Peabody,3,2,252,43,2,9,306
Peabody,3,3,265,45,1,25,336
Peabody,4,1,301,52,0,19,372
Peabody,4,2,168,32,1,12,213
Peabody,4,3,136,18,0,6,160
Peabody,4,3A,564,37,1,12,614
Peabody,5,1,369,62,2,19,452
Peabody,5,2,237,38,0,11,286
Peabody,5,3,279,32,0,11,322
Peabody,6,1,431,57,2,18,508
Peabody,6,2,319,34,6,10,369
Peabody,6,3,328,41,4,20,393
Pelham,-,1,322,36,0,5,363
Pembroke,-,1,316,40,0,6,362
Pembroke,-,2,283,33,1,3,320
Pembroke,-,3,287,26,1,3,317
Pembroke,-,3A,4,2,0,0,6
Pembroke,-,4,279,24,2,4,309
Pembroke,-,5,267,26,2,11,306
Pepperell,-,1,217,51,1,2,271
Pepperell,-,2,327,34,2,1,364
Pepperell,-,3,268,41,1,4,314
Pepperell,-,4,261,27,0,0,288
Peru,-,1,90,33,0,17,140
Petersham,-,1,176,20,0,2,198
Phillipston,-,1,105,18,0,0,123
Pittsfield,1,A,271,67,2,46,386
Pittsfield,1,B,490,116,1,84,691
Pittsfield,2,A,152,54,1,15,222
Pittsfield,2,B,410,150,0,93,653
Pittsfield,3,A,540,138,2,82,762
Pittsfield,3,B,606,160,1,126,893
Pittsfield,4,A,525,150,2,108,785
Pittsfield,4,B,710,146,7,139,1002
Pittsfield,5,A,422,136,0,58,616
Pittsfield,5,B,468,112,0,61,641
Pittsfield,6,A,510,103,0,82,695
Pittsfield,6,B,303,87,1,43,434
Pittsfield,7,A,201,75,1,31,308
Pittsfield,7,B,460,133,1,80,674
Plainfield,-,1,123,24,0,1,148
Plainville,-,1,224,28,0,3,255
Plainville,-,2,271,35,0,2,308
Plainville,-,3,269,31,0,4,304
Plymouth,-,1,262,40,0,4,306
Plymouth,-,2,335,32,0,4,371
Plymouth,-,3,376,54,1,9,440
Plymouth,-,4,359,38,2,6,405
Plymouth,-,5,354,36,1,2,393
Plymouth,-,6,403,43,1,10,457
Plymouth,-,7,364,43,1,6,414
Plymouth,-,8,382,29,1,4,416
Plymouth,-,9,235,37,0,4,276
Plymouth,-,10,339,38,0,6,383
Plymouth,-,11,344,35,2,4,385
Plymouth,-,12,222,38,0,3,263
Plymouth,-,13,407,38,0,13,458
Plymouth,-,14,300,46,0,5,351
Plymouth,-,15,846,47,0,11,904
Plymouth,-,16,695,40,0,20,755
Plymouth,-,17,349,42,0,5,396
Plymouth,-,18,208,40,1,9,258
Plympton,-,1,229,26,0,5,260
Princeton,-,1,405,66,0,10,481
Provincetown,-,1,1175,101,0,18,1294
Quincy,1,1,226,47,1,12,286
Quincy,1,2,217,58,1,22,298
Quincy,1,3,261,58,0,11,330
Quincy,1,4,411,51,6,21,489
Quincy,1,5,377,55,5,23,460
Quincy,2,1,209,29,0,1,239
Quincy,2,2,227,33,3,10,273
Quincy,2,3,160,41,0,0,201
Quincy,2,4,157,35,0,10,202
Quincy,2,5,245,55,2,13,315
Quincy,3,1,325,54,1,8,388
Quincy,3,2,309,54,2,14,379
Quincy,3,3,213,39,2,9,263
Quincy,3,4,250,41,2,9,302
Quincy,3,5,286,58,2,28,374
Quincy,4,1,210,40,0,11,261
Quincy,4,2,267,59,3,16,345
Quincy,4,3,280,42,3,14,339
Quincy,4,4,179,33,1,14,227
Quincy,4,5,157,32,2,2,193
Quincy,5,1,97,24,3,3,127
Quincy,5,1A,78,15,0,3,96
Quincy,5,2,273,65,3,10,351
Quincy,5,3,322,68,2,19,411
Quincy,5,4,220,40,1,13,274
Quincy,5,5,348,55,5,20,428
Quincy,6,1,235,48,1,6,290
Quincy,6,2,190,45,1,11,247
Quincy,6,3,362,49,2,13,426
Quincy,6,4,235,44,1,14,294
Quincy,6,5,558,72,11,57,698
Randolph,-,1,287,55,3,7,352
Randolph,-,2,224,64,1,4,293
Randolph,-,3,215,47,2,5,269
Randolph,-,4,259,47,1,15,322
Randolph,-,5,261,56,3,8,328
Randolph,-,6,126,23,0,2,151
Randolph,-,7,233,47,2,4,286
Randolph,-,8,232,41,1,10,284
Randolph,-,9,252,42,0,8,302
Randolph,-,10,213,41,0,10,264
Randolph,-,11,221,66,3,7,297
Randolph,-,12,214,60,1,15,290
Raynham,-,1,253,35,0,7,295
Raynham,-,2,156,38,0,10,204
Raynham,-,2A,79,8,0,2,89
Raynham,-,3,292,44,0,9,345
Raynham,-,4,181,28,0,7,216
Raynham,-,4A,4,1,0,0,5
Reading,-,1,437,33,1,6,477
Reading,-,2,365,43,1,6,415
Reading,-,3,477,50,0,7,534
Reading,-,4,396,35,1,10,442
Reading,-,5,417,35,0,13,465
Reading,-,6,418,48,0,9,475
Reading,-,7,423,42,1,12,478
Reading,-,8,313,38,3,6,360
Rehoboth,-,1,164,29,0,4,197
Rehoboth,-,2,190,48,0,6,244
Rehoboth,-,3,180,32,0,2,214
Rehoboth,-,4,180,40,0,9,229
Revere,1,1,196,40,0,6,242
Revere,1,2,157,36,0,3,196
Revere,1,3,113,30,0,3,146
Revere,2,1,93,20,0,0,113
Revere,2,2,138,40,1,6,185
Revere,2,3,22,19,0,0,41
Revere,2,3A,5,9,0,0,14
Revere,3,1,104,38,1,4,147
Revere,3,2,118,37,1,8,164
Revere,3,3,131,44,1,10,186
Revere,4,1,145,32,1,6,184
Revere,4,2,92,33,0,4,129
Revere,4,3,177,36,2,13,228
Revere,5,1,296,72,4,23,395
Revere,5,2,167,44,0,5,216
Revere,5,3,82,26,2,11,121
Revere,6,1,176,36,5,10,227
Revere,6,2,175,27,2,12,216
Revere,6,3,126,28,0,4,158
Richmond,-,1,388,57,0,34,479
Rochester,-,1,500,104,2,14,620
Rockland,-,1,246,43,3,12,304
Rockland,-,2,273,34,2,6,315
Rockland,-,3,195,27,1,4,227
Rockland,-,4,186,21,0,1,208
Rockland,-,5,191,23,1,7,222
Rockland,-,6,213,26,3,1,243
Rockport,-,1,432,34,0,6,472
Rockport,-,2,521,59,1,14,595
Rockport,-,3,647,68,0,16,731
Rowe,-,1,58,10,0,0,68
Rowley,-,1,620,71,1,14,706
Royalston,-,1,160,25,0,4,189
Russell,-,1,80,22,0,6,108
Rutland,-,1,181,35,0,2,218
Rutland,-,2,252,41,0,1,294
Rutland,-,3,154,36,1,3,194
Salem,1,1,710,115,0,47,872
Salem,1,2,143,68,1,52,264
Salem,2,1,635,89,2,21,747
Salem,2,2,731,99,1,19,850
Salem,3,1,421,97,2,35,555
Salem,3,2,418,76,0,27,521
Salem,4,1,396,82,0,31,509
Salem,4,2,434,79,0,32,545
Salem,5,1,532,87,2,28,649
Salem,5,2,380,81,2,32,495
Salem,6,1,498,111,1,41,651
Salem,6,2,509,101,4,27,641
Salem,7,1,282,52,1,22,357
Salem,7,2,532,75,3,27,637
Salisbury,-,1,323,33,0,14,370
Salisbury,-,2,305,32,1,10,348
Salisbury,-,3,203,49,2,9,263
Sandisfield,-,1,72,18,0,4,94
Sandwich,-,1,504,58,1,5,568
Sandwich,-,2,467,35,1,3,506
Sandwich,-,3,342,35,0,4,381
Sandwich,-,4,370,35,0,2,407
Sandwich,-,5,312,34,1,4,351
Sandwich,-,6,265,51,0,4,320
Saugus,-,1,227,38,0,11,276
Saugus,-,2,204,30,0,12,246
Saugus,-,3,184,34,0,5,223
Saugus,-,4,227,27,0,13,267
Saugus,-,5,201,33,0,13,247
Saugus,-,6,180,29,0,7,216
Saugus,-,7,217,36,0,5,258
Saugus,-,8,231,25,3,11,270
Saugus,-,9,219,29,0,12,260
Saugus,-,10,151,34,0,4,189
Savoy,-,1,77,17,0,10,104
Scituate,-,1,421,32,0,7,460
Scituate,-,2,401,34,1,4,440
Scituate,-,3,436,33,1,10,480
Scituate,-,4,467,31,3,14,515
Scituate,-,5,438,49,0,11,498
Scituate,-,6,437,43,1,12,493
Seekonk,-,1,206,41,0,7,254
Seekonk,-,2,314,30,2,7,353
Seekonk,-,3,190,39,1,7,237
Seekonk,-,4,185,47,0,2,234
Sharon,-,1,557,60,1,13,631
Sharon,-,2,460,45,0,9,514
Sharon,-,3,452,56,2,7,517
Sharon,-,4,463,76,1,8,548
Sharon,-,5,477,38,2,10,527
Sheffield,-,1,419,75,1,30,525
Shelburne,-,1,294,28,2,61,385
Sherborn,-,1,587,68,1,14,670
Shirley,-,1,488,84,2,9,583
Shrewsbury,-,1,363,51,1,8,423
Shrewsbury,-,2,255,31,1,2,289
Shrewsbury,-,3,226,32,0,3,261
Shrewsbury,-,4,256,47,0,1,304
Shrewsbury,-,5,265,48,0,4,317
Shrewsbury,-,6,312,46,0,5,363
Shrewsbury,-,7,301,46,3,7,357
Shrewsbury,-,8,427,52,0,9,488
Shrewsbury,-,9,223,20,0,7,250
Shrewsbury,-,10,265,32,0,4,301
Shutesbury,-,1,370,69,0,4,443
Somerset,-,1,391,90,0,29,510
Somerset,-,2,418,74,0,22,514
Somerset,-,3,433,69,0,20,522
Somerset,-,4,332,75,0,14,421
Somerset,-,5,308,74,0,19,401
Somerville,1,1,212,67,1,11,291
Somerville,1,2,206,60,5,4,275
Somerville,1,3,168,48,1,3,220
Somerville,1,4,104,46,1,5,156
Somerville,1,4A,74,19,4,4,101
Somerville,2,1,188,66,0,6,260
Somerville,2,1A,109,34,0,1,144
Somerville,2,2,348,74,1,8,431
Somerville,2,3,306,88,0,11,405
Somerville,2,4,369,87,0,9,465
Somerville,3,1,464,105,1,14,584
Somerville,3,2,399,73,3,15,490
Somerville,3,3,427,103,1,9,540
Somerville,3,4,414,91,2,10,517
Somerville,4,1,233,51,1,2,287
Somerville,4,2,189,52,0,5,246
Somerville,4,2A,77,21,1,3,102
Somerville,4,3,351,85,3,11,450
Somerville,4,4,145,43,1,4,193
Somerville,5,1,406,99,0,13,518
Somerville,5,2,453,102,6,16,577
Somerville,5,3,458,106,0,12,576
Somerville,5,4,470,119,1,13,603
Somerville,6,1,526,86,4,15,631
Somerville,6,2,546,117,4,20,687
Somerville,6,3,49,13,0,4,66
Somerville,6,3A,66,12,0,1,79
Somerville,6,4,469,104,0,19,592
Somerville,7,1,476,100,1,4,581
Somerville,7,2,296,71,0,6,373
Somerville,7,3,259,76,1,16,352
Somerville,7,4,350,89,1,11,451
S. Hadley,-,A,385,73,3,7,468
S. Hadley,-,B,566,83,0,16,665
S. Hadley,-,C,469,73,1,16,559
S. Hadley,-,D,304,47,4,6,361
S. Hadley,-,E,471,74,2,11,558
Southampton,-,1,377,65,17,2,461
Southampton,-,2,341,59,0,10,410
Southborough,-,1,380,42,0,10,432
Southborough,-,2,298,47,0,11,356
Southborough,-,3,360,51,0,2,413
Southbridge,-,1,136,43,0,2,181
Southbridge,-,2,101,29,0,1,131
Southbridge,-,3,171,35,1,1,208
Southbridge,-,4,279,57,0,6,342
Southbridge,-,5,118,40,1,5,164
Southwick,-,1,197,43,0,6,246
Southwick,-,2,161,35,0,3,199
Southwick,-,3,219,44,0,4,267
Spencer,-,1,181,39,1,5,226
Spencer,-,2,157,28,0,3,188
Spencer,-,3,180,33,0,3,216
Spencer,-,4,202,38,1,0,241
Springfield,1,A,150,109,0,7,266
Springfield,1,B,42,32,0,3,77
Springfield,1,C,34,20,0,1,55
Springfield,1,C1,4,2,1,0,7
Springfield,1,D,26,21,0,2,49
Springfield,1,D1,4,3,0,1,8
Springfield,1,E,54,21,0,3,78
Springfield,1,F,74,52,0,3,129
Springfield,1,G,53,29,1,3,86
Springfield,1,H,115,55,0,2,172
Springfield,2,A,57,23,0,6,86
Springfield,2,B,149,56,0,15,220
Springfield,2,C,73,26,0,7,106
Springfield,2,D,113,48,0,1,162
Springfield,2,E,122,48,1,11,182
Springfield,2,F,106,43,2,1,152
Springfield,2,G,152,40,0,9,201
Springfield,2,H,111,38,0,7,156
Springfield,3,A,48,32,1,5,86
Springfield,3,B,54,30,0,9,93
Springfield,3,C,52,17,0,5,74
Springfield,3,D,52,28,0,4,84
Springfield,3,E,22,9,0,1,32
Springfield,3,F,46,12,0,4,62
Springfield,3,G,33,9,0,0,42
Springfield,3,H,48,22,1,1,72
Springfield,4,A,170,55,0,14,239
Springfield,4,B,64,29,1,7,101
Springfield,4,C,59,23,0,1,83
Springfield,4,D,79,27,0,4,110
Springfield,4,E,58,15,0,4,77
Springfield,4,F,30,11,0,2,43
Springfield,4,G,118,49,0,8,175
Springfield,4,H,112,42,0,3,157
Springfield,5,A,157,32,0,11,200
Springfield,5,B,134,38,0,5,177
Springfield,5,C,103,30,0,7,140
Springfield,5,C1,0,1,0,0,1
Springfield,5,D,199,50,1,10,260
Springfield,5,E,171,50,2,12,235
Springfield,5,F,207,47,2,11,267
Springfield,5,G,206,54,2,8,270
Springfield,5,H,151,42,0,8,201
Springfield,6,A,95,38,0,4,137
Springfield,6,B,239,39,1,15,294
Springfield,6,C,127,33,1,7,168
Springfield,6,D,227,45,1,22,295
Springfield,6,D1,8,2,0,0,10
Springfield,6,E,62,27,0,5,94
Springfield,6,F,84,31,0,2,117
Springfield,6,G,123,40,1,7,171
Springfield,6,H,161,28,4,5,198
Springfield,7,A,202,43,0,13,258
Springfield,7,A1,7,1,0,0,8
Springfield,7,B,289,70,2,30,391
Springfield,7,B1,5,2,0,1,8
Springfield,7,C,256,48,1,20,325
Springfield,7,D,178,40,4,14,236
Springfield,7,E,107,26,5,3,141
Springfield,7,F,283,48,4,15,350
Springfield,7,G,254,55,0,10,319
Springfield,7,H,106,14,0,3,123
Springfield,7,H1,14,2,0,2,18
Springfield,8,A,114,28,1,3,146
Springfield,8,B,125,31,1,4,161
Springfield,8,B1,9,2,0,0,11
Springfield,8,C,128,48,0,3,179
Springfield,8,D,38,19,0,6,63
Springfield,8,E,44,24,0,0,68
Springfield,8,F,94,28,1,1,124
Springfield,8,G,107,30,2,8,147
Springfield,8,G1,3,2,0,0,5
Springfield,8,H,114,29,0,5,148
Sterling,-,1,358,35,1,3,397
Sterling,-,2,403,59,1,7,470
Stockbridge,-,1,430,69,0,36,535
Stoneham,-,1,351,51,1,13,416
Stoneham,-,2,339,49,0,11,399
Stoneham,-,3,370,36,0,13,419
Stoneham,-,4,312,45,1,4,362
Stoneham,-,5,288,21,0,6,315
Stoneham,-,6,437,49,1,11,498
Stoneham,-,7,289,52,1,5,347
Stoughton,-,1,290,54,0,16,360
Stoughton,-,2,275,57,0,11,343
Stoughton,-,2A,0,0,0,0,0
Stoughton,-,3,339,59,1,11,410
Stoughton,-,4,382,65,0,17,464
Stoughton,-,4A,0,0,0,0,0
Stoughton,-,5,229,62,0,15,306
Stoughton,-,5A,0,0,0,0,0
Stoughton,-,6,372,54,0,14,440
Stoughton,-,7,312,43,1,10,366
Stoughton,-,7A,0,0,0,0,0
Stoughton,-,8,214,55,0,11,280
Stoughton,-,8A,0,0,0,0,0
Stow,-,1,630,66,1,11,708
Stow,-,2,659,77,0,13,749
Sturbridge,-,1,301,39,0,3,343
Sturbridge,-,2,264,40,1,2,307
Sturbridge,-,3,269,43,0,8,320
Sudbury,-,1,387,39,0,6,432
Sudbury,-,2,433,40,0,2,475
Sudbury,-,3,386,36,0,9,431
Sudbury,-,4,400,26,0,6,432
Sudbury,-,5,349,39,0,5,393
Sudbury,-,6,420,36,0,3,459
Sunderland,-,1,415,70,0,5,490
Sutton,-,1,216,33,0,1,250
Sutton,-,2,229,27,0,3,259
Sutton,-,3,212,35,0,6,253
Swampscott,-,1,399,45,3,16,463
Swampscott,-,2,368,48,2,17,435
Swampscott,-,3,521,60,3,17,601
Swampscott,-,4,566,68,6,29,669
Swampscott,-,5,467,67,3,32,569
Swampscott,-,6,512,55,2,23,592
Swansea,-,1,253,53,0,6,312
Swansea,-,2,337,51,1,15,404
Swansea,-,3,315,73,1,23,412
Swansea,-,4,260,37,2,10,309
Swansea,-,5,241,52,0,17,310
Taunton,1,A,160,40,0,7,207
Taunton,1,A1,8,5,0,1,14
Taunton,1,B,228,46,0,11,285
Taunton,2,A,91,22,1,4,118
Taunton,2,B,123,45,0,10,178
Taunton,3,A,201,47,0,9,257
Taunton,3,B,222,43,0,4,269
Taunton,4,A,196,40,0,12,248
Taunton,4,B,183,38,0,10,231
Taunton,4,B1,4,1,0,0,5
Taunton,5,A,152,29,0,7,188
Taunton,5,B,151,37,0,8,196
Taunton,6,A,127,31,0,6,164
Taunton,6,B,170,43,2,6,221
Taunton,7,A,259,47,0,17,323
Taunton,7,B,226,47,3,9,285
Taunton,8,A,265,53,0,13,331
Taunton,8,B,326,50,1,10,387
Templeton,-,A,177,37,0,7,221
Templeton,-,B,161,24,0,3,188
Templeton,-,C,156,24,0,0,180
Tewksbury,-,1,284,57,1,5,347
Tewksbury,-,2,316,51,2,7,376
Tewksbury,-,3,274,47,1,11,333
Tewksbury,-,4,342,53,2,9,406
Tewksbury,-,5,293,48,0,3,344
Tewksbury,-,5A,57,10,0,1,68
Tewksbury,-,6,280,50,0,6,336
Tewksbury,-,7,374,56,1,7,438
Tewksbury,-,8,342,43,1,10,396
Tisbury,-,1,697,120,1,29,847
Tolland,-,1,33,6,0,0,39
Topsfield,-,1,363,36,0,41,440
Topsfield,-,2,350,31,1,27,409
Townsend,-,1,194,43,0,4,241
Townsend,-,2,231,40,0,5,276
Townsend,-,3,248,32,0,7,287
Truro,-,1,634,44,0,12,690
Tyngsborough,-,1,271,31,0,4,306
Tyngsborough,-,2,205,42,0,4,251
Tyngsborough,-,3,211,37,0,3,251
Tyngsborough,-,4,309,22,0,5,336
Tyringham,-,1,94,11,2,15,122
Upton,-,1,257,43,0,2,302
Upton,-,2,240,33,0,6,279
Upton,-,3,235,33,1,2,271
Uxbridge,-,1,261,42,1,3,307
Uxbridge,-,1A,17,2,0,0,19
Uxbridge,-,2,239,45,1,2,287
Uxbridge,-,3,226,27,0,9,262
Uxbridge,-,4,249,44,0,2,295
Wakefield,-,1,334,56,0,4,394
Wakefield,-,2,380,40,0,6,426
Wakefield,-,3,437,78,0,0,515
Wakefield,-,4,441,69,1,13,524
Wakefield,-,5,444,48,1,9,502
Wakefield,-,6,443,71,2,13,529
Wakefield,-,7,404,51,0,11,466
Wales,-,1,108,18,0,1,127
Walpole,-,1,277,40,4,6,327
Walpole,-,2,299,32,0,11,342
Walpole,-,2A,1,0,0,0,1
Walpole,-,3,418,60,0,8,486
Walpole,-,4,258,31,0,7,296
Walpole,-,5,217,34,1,13,265
Walpole,-,5A,7,0,0,0,7
Walpole,-,6,318,38,0,8,364
Walpole,-,7,318,39,1,7,365
Walpole,-,8,285,42,0,13,340
Waltham,1,1,472,73,1,21,567
Waltham,1,2,469,60,1,19,549
Waltham,1,2A,2,0,0,0,2
Waltham,2,1,402,62,0,21,485
Waltham,2,2,263,45,0,5,313
Waltham,3,1,407,35,1,19,462
Waltham,3,2,429,54,1,13,497
Waltham,3,2A,7,1,0,0,8
Waltham,4,1,441,64,3,17,525
Waltham,4,1A,10,0,0,0,10
Waltham,4,2,61,11,0,2,74
Waltham,5,1,294,55,2,7,358
Waltham,5,2,177,53,0,6,236
Waltham,5,2A,45,5,0,1,51
Waltham,6,1,321,56,0,10,387
Waltham,6,2,177,34,0,5,216
Waltham,6,2A,33,13,0,3,49
Waltham,7,1,467,74,2,18,561
Waltham,7,2,153,27,0,5,185
Waltham,8,1,274,52,0,14,340
Waltham,8,2,276,48,2,7,333
Waltham,8,2A,3,2,0,0,5
Waltham,9,1,187,52,1,5,245
Waltham,9,2,187,47,1,5,240
Ware,-,A,180,48,2,5,235
Ware,-,B,153,42,1,7,203
Ware,-,C,293,41,0,5,339
Wareham,-,1,300,47,2,3,352
Wareham,-,2,340,49,0,0,389
Wareham,-,3,346,49,1,5,401
Wareham,-,4,273,44,0,0,317
Wareham,-,5,290,37,4,4,335
Wareham,-,6,227,48,1,2,278
Warren,-,A,187,36,0,3,226
Warren,-,B,65,23,0,0,88
Warwick,-,1,111,11,0,1,123
Washington,-,1,87,24,1,11,123
Watertown,-,1,288,49,0,10,347
Watertown,-,2,326,71,1,5,403
Watertown,-,3,398,86,0,13,497
Watertown,-,4,551,77,3,11,642
Watertown,-,5,265,58,0,7,330
Watertown,-,6,290,59,2,9,360
Watertown,-,7,450,48,2,7,507
Watertown,-,8,416,58,1,8,483
Watertown,-,9,279,59,2,7,347
Watertown,-,10,344,37,0,13,394
Watertown,-,11,384,58,1,12,455
Watertown,-,12,326,55,3,6,390
Wayland,-,1,519,46,0,9,574
Wayland,-,2,387,50,0,5,442
Wayland,-,3,407,50,9,7,473
Wayland,-,4,483,41,3,2,529
Webster,-,1,92,16,0,2,110
Webster,-,1A,40,18,1,1,60
Webster,-,2,100,24,0,3,127
Webster,-,3,173,27,0,2,202
Webster,-,4,255,49,2,8,314
Webster,-,5,199,36,0,6,241
Wellesley,-,A,434,36,2,13,485
Wellesley,-,B,532,51,1,15,599
Wellesley,-,C,355,35,0,11,401
Wellesley,-,D,518,28,0,10,556
Wellesley,-,E,413,43,0,7,463
Wellesley,-,F,260,12,0,3,275
Wellesley,-,G,263,20,0,5,288
Wellesley,-,H,455,54,1,16,526
Wellfleet,-,1,822,80,1,12,915
Wendell,-,1,166,21,0,1,188
Wenham,-,1,195,21,0,4,220
Wenham,-,1A,285,31,1,5,322
W. Boylston,-,1,435,42,1,15,493
W. Boylston,-,2,426,46,0,16,488
W. Bridgewater,-,1,270,38,1,7,316
W. Bridgewater,-,2,271,27,0,13,311
W. Brookfield,-,1,303,46,2,7,358
W. Newbury,-,1,651,59,0,7,717
W. Springfield,-,1,66,25,1,1,93
W. Springfield,-,2,90,33,0,3,126
W. Springfield,-,3,198,42,0,11,251
W. Springfield,-,4,227,42,1,11,281
W. Springfield,-,5,338,46,0,22,406
W. Springfield,-,6,283,41,0,13,337
W. Springfield,-,7,238,47,0,17,302
W. Springfield,-,8,208,40,0,6,254
W. Stockbridge,-,1,309,60,1,36,406
W. Tisbury,-,1,667,69,0,22,758
Westborough,-,1,234,35,1,5,275
Westborough,-,2,199,29,0,6,234
Westborough,-,3,254,30,0,0,284
Westborough,-,4,208,24,0,0,232
Westborough,-,5,378,41,0,3,422
Westborough,-,6,473,51,1,8,533
Westfield,1,A,300,49,2,11,362
Westfield,1,B,214,56,2,7,279
Westfield,2,A,104,27,0,2,133
Westfield,2,A1,11,4,0,0,15
Westfield,2,B,185,47,0,7,239
Westfield,3,A,115,33,0,8,156
Westfield,3,B,257,59,0,9,325
Westfield,4,A,101,21,2,4,128
Westfield,4,B,355,47,0,12,414
Westfield,5,A,306,53,2,18,379
Westfield,5,B,292,48,0,15,355
Westfield,6,A,227,47,2,8,284
Westfield,6,B,168,36,1,3,208
Westfield,6,B1,13,3,0,0,16
Westford,-,1,390,39,0,7,436
Westford,-,2,294,61,4,1,360
Westford,-,3,290,44,2,6,342
Westford,-,4,415,46,1,7,469
Westford,-,5,384,52,1,4,441
Westford,-,6,284,37,2,5,328
Westford,-,7,438,48,1,3,490
Westhampton,-,1,292,34,0,17,343
Westminster,-,1,228,28,1,3,260
Westminster,-,2,185,16,0,1,202
Westminster,-,2A,64,7,0,3,74
Westminster,-,3,229,30,0,3,262
Weston,-,1,378,40,1,6,425
Weston,-,2,312,20,3,6,341
Weston,-,3,271,30,0,8,309
Weston,-,4,270,40,0,10,320
Westport,-,A,272,53,0,8,333
Westport,-,B,432,56,0,21,509
Westport,-,C,222,48,0,6,276
Westport,-,D,237,59,0,20,316
Westport,-,E,388,60,0,20,468
Westwood,-,1,437,39,0,11,487
Westwood,-,2,379,47,1,11,438
Westwood,-,3,365,33,1,12,411
Westwood,-,4,261,54,2,8,325
Westwood,-,5,401,46,0,12,459
Weymouth,-,1,288,44,1,7,340
Weymouth,-,2,419,41,1,5,466
Weymouth,-,3,316,46,2,14,378
Weymouth,-,4,292,38,0,12,342
Weymouth,-,5,240,51,1,6,298
Weymouth,-,6,351,54,6,15,426
Weymouth,-,7,245,43,0,3,291
Weymouth,-,8,270,52,1,5,328
Weymouth,-,9,200,24,0,4,228
Weymouth,-,9A,87,11,0,4,102
Weymouth,-,10,247,26,0,6,279
Weymouth,-,11,187,34,2,10,233
Weymouth,-,12,322,35,0,5,362
Weymouth,-,13,190,26,0,7,223
Weymouth,-,14,317,42,3,8,370
Weymouth,-,15,343,45,0,11,399
Weymouth,-,16,339,46,1,10,396
Weymouth,-,17,247,34,1,5,287
Weymouth,-,18,296,40,1,9,346
Whately,-,1,242,24,0,7,273
Whitman,-,1,352,50,2,4,408
Whitman,-,2,237,36,0,6,279
Whitman,-,3,287,32,2,8,329
Whitman,-,4,268,24,2,10,304
Wilbraham,-,A,395,51,3,16,465
Wilbraham,-,B,329,62,1,16,408
Wilbraham,-,C,313,53,3,13,382
Wilbraham,-,D,407,71,3,28,509
Williamsburg,-,1,523,89,0,10,622
Williamstown,-,1,517,82,1,30,630
Williamstown,-,2,146,25,0,6,177
Williamstown,-,3,584,85,0,29,698
Wilmington,-,1,321,59,1,2,383
Wilmington,-,2,343,64,0,14,421
Wilmington,-,3,310,46,2,3,361
Wilmington,-,4,361,56,2,9,428
Wilmington,-,5,345,46,1,6,398
Wilmington,-,6,361,53,0,10,424
Winchendon,-,1,128,30,1,2,161
Winchendon,-,2,212,18,0,4,234
Winchendon,-,3,185,31,2,1,219
Winchester,-,1,323,41,0,8,372
Winchester,-,2,282,48,0,6,336
Winchester,-,3,475,29,1,9,514
Winchester,-,4,361,28,1,8,398
Winchester,-,5,309,27,1,5,342
Winchester,-,6,291,47,2,6,346
Winchester,-,7,314,21,0,12,347
Winchester,-,8,211,23,0,3,237
Windsor,-,1,133,20,0,11,164
Winthrop,-,1,279,36,5,8,328
Winthrop,-,2,300,39,1,23,363
Winthrop,-,3,258,40,2,10,310
Winthrop,-,4,286,53,1,12,352
Winthrop,-,5,348,39,1,26,414
Winthrop,-,6,289,45,2,8,344
Woburn,1,1,214,36,3,7,260
Woburn,1,2,268,33,0,8,309
Woburn,1,2A,15,5,0,1,21
Woburn,2,1,261,42,1,3,307
Woburn,2,2,216,45,1,4,266
Woburn,3,1,299,35,1,7,342
Woburn,3,2,282,45,1,12,340
Woburn,4,1,293,53,2,9,357
Woburn,4,2,232,46,0,2,280
Woburn,5,1,217,41,2,7,267
Woburn,5,2,240,35,0,11,286
Woburn,6,1,127,32,1,2,162
Woburn,6,2,206,33,0,4,243
Woburn,7,1,330,39,3,12,384
Woburn,7,2,319,49,0,6,374
Worcester,1,1,273,42,2,17,334
Worcester,1,2,572,65,2,36,675
Worcester,1,3,302,55,2,15,374
Worcester,1,4,538,82,4,22,646
Worcester,1,5,215,48,2,11,276
Worcester,1,6,380,82,3,21,486
Worcester,2,1,386,60,1,9,456
Worcester,2,2,310,54,1,17,382
Worcester,2,3,326,54,2,20,402
Worcester,2,4,206,52,0,10,268
Worcester,2,5,114,35,0,0,149
Worcester,2,6,242,49,3,11,305
Worcester,3,1,67,30,0,5,102
Worcester,3,2,66,28,0,4,98
Worcester,3,3,196,47,2,14,259
Worcester,3,4,80,32,0,2,114
Worcester,3,5,204,57,2,8,271
Worcester,3,6,227,55,1,13,296
Worcester,4,1,42,27,0,4,73
Worcester,4,2,51,14,0,4,69
Worcester,4,2A,46,11,1,3,61
Worcester,4,3,81,25,1,0,107
Worcester,4,4,124,40,1,1,166
Worcester,4,5,217,39,0,11,267
Worcester,4,6,170,32,1,5,208
Worcester,5,1,96,34,0,0,130
Worcester,5,2,187,42,0,4,233
Worcester,5,3,306,33,0,5,344
Worcester,5,4,232,39,1,11,283
Worcester,5,5,211,49,0,14,274
Worcester,5,6,150,35,0,11,196
Worcester,6,1,45,15,1,4,65
Worcester,6,2,71,32,1,2,106
Worcester,6,3,72,30,0,3,105
Worcester,6,4,23,5,0,0,28
Worcester,6,5,114,34,0,4,152
Worcester,6,6,174,38,1,6,219
Worcester,7,1,277,54,1,11,343
Worcester,7,2,179,45,1,5,230
Worcester,7,3,129,33,1,3,166
Worcester,7,4,227,38,0,4,269
Worcester,7,5,125,29,0,7,161
Worcester,7,5A,40,6,0,1,47
Worcester,7,6,184,52,0,4,240
Worcester,8,1,68,20,0,1,89
Worcester,8,2,45,20,0,5,70
Worcester,8,3,31,13,0,2,46
Worcester,8,4,120,65,2,10,197
Worcester,8,5,69,33,0,0,102
Worcester,8,6,51,23,0,5,79
Worcester,9,1,204,67,0,9,280
Worcester,9,2,427,72,1,14,514
Worcester,9,3,188,35,0,6,229
Worcester,9,4,406,58,0,8,472
Worcester,9,5,523,102,2,31,658
Worcester,9,6,374,69,2,15,460
Worcester,10,1,96,28,0,5,129
Worcester,10,2,121,35,0,10,166
Worcester,10,3,102,50,0,2,154
Worcester,10,4,61,58,0,7,126
Worcester,10,5,56,25,0,6,87
Worcester,10,6,65,26,0,5,96
Worthington,-,1,215,29,0,6,250
Wrentham,-,1,221,33,0,8,262
Wrentham,-,2,246,43,1,3,293
Wrentham,-,3,269,44,2,8,323
Wrentham,-,4,244,38,0,5,287
Yarmouth,-,1,536,35,0,13,584
Yarmouth,-,2,485,32,2,3,522
Yarmouth,-,3,277,47,1,6,331
Yarmouth,-,4,365,29,0,7,401
Yarmouth,-,5,294,35,0,6,335
Yarmouth,-,6,331,49,0,6,386
Yarmouth,-,7,590,40,1,7,638
Yarmouth,-,8,288,20,0,4,312
Yarmouth,-,8A,52,11,0,3,66
