City/Town,Obama/ Biden,Romney/ Ryan,Johnson/ Gray,Stein/ Honkala,All Others,No Preference,Blanks,Total Votes Cast
Abington,4144,4061,53,37,20,0,28,8343
Acton,7872,3875,136,83,17,0,39,12022
Acushnet,3046,2196,59,26,18,0,53,5398
Adams,3013,819,53,25,9,0,12,3931
Agawam,7288,6870,136,60,33,0,56,14443
Alford,233,64,1,6,0,0,2,306
Amesbury,4863,3427,101,34,21,0,77,8523
Amherst,12798,1911,270,444,61,0,36,15520
Andover,9401,9096,181,82,0,0,70,18830
Aquinnah,252,38,2,6,0,0,1,299
Arlington,18850,6694,249,316,50,0,94,26253
Ashburnham,1632,1535,38,24,18,0,7,3254
Ashby,827,961,32,10,5,0,8,1843
Ashfield,892,187,11,31,1,0,8,1130
Ashland,4979,3409,115,36,9,0,27,8575
Athol,2543,2079,78,41,14,0,15,4770
Attleboro,10502,8470,263,95,54,0,45,19429
Auburn,4520,4121,106,63,18,0,44,8872
Avon,1222,1131,31,11,0,0,18,2413
Ayer,2025,1558,43,21,6,0,15,3668
Barnstable,12947,12355,181,128,0,0,123,25734
Barre,1345,1279,36,25,11,0,12,2708
Becket,686,259,14,10,1,0,5,975
Bedford,4469,3061,90,60,18,0,21,7719
Belchertown,4600,2914,73,81,15,0,22,7705
Bellingham,4263,4133,110,30,24,0,24,8584
Belmont,9313,4752,111,137,28,0,49,14390
Berkley,1573,1689,32,10,16,0,18,3338
Berlin,921,830,35,21,0,0,7,1814
Bernardston,809,329,19,9,8,0,7,1181
Beverly,12158,8328,263,114,53,0,104,21020
Billerica,9839,9959,210,92,64,0,82,20246
Blackstone,2222,2028,50,17,8,0,19,4344
Blandford,300,348,7,5,1,0,6,667
Bolton,1554,1463,37,15,7,0,10,3086
Boston,200190,48985,2119,2112,483,0,1132,255021
Bourne,4812,5296,68,40,28,0,30,10274
Boxborough,1753,1140,33,25,0,0,14,2965
Boxford,2066,3034,48,14,13,0,18,5193
Boylston,1283,1343,36,17,8,0,6,2693
Braintree,10059,9232,157,75,51,0,97,19671
Brewster,3678,2752,60,40,13,0,36,6579
Bridgewater,5777,6098,110,47,28,0,55,12115
Brimfield,897,1095,31,20,3,0,8,2054
Brockton,25262,8710,227,85,50,0,151,34485
Brookfield,830,858,26,19,5,0,5,1743
Brookline,22277,5880,208,255,33,0,136,28789
Buckland,750,252,11,21,0,0,21,1055
Burlington,6983,6191,115,46,25,0,48,13408
Cambridge,43515,5476,568,938,122,0,130,50749
Canton,6488,5779,102,37,13,0,52,12471
Carlisle,1972,1318,32,39,3,0,10,3374
Carver,2872,3111,49,20,13,0,21,6086
Charlemont,456,166,6,11,0,0,4,643
Charlton,2914,3662,95,41,12,0,22,6746
Chatham,2293,2280,26,23,16,0,16,4654
Chelmsford,9651,9573,224,99,33,0,84,19664
Chelsea,6802,1515,70,36,0,0,220,8643
Cheshire,1219,493,23,10,2,0,14,1761
Chester,331,305,18,7,3,0,3,667
Chesterfield,455,228,17,16,0,0,7,723
Chicopee,14302,8241,263,133,97,0,168,23204
Chilmark,589,127,7,8,3,0,4,738
Clarksburg,616,232,5,7,0,0,5,865
Clinton,3768,2621,90,36,19,0,32,6566
Cohasset,2250,2601,35,9,10,0,13,4918
Colrain,618,232,19,12,5,0,7,893
Concord,7316,3527,95,76,12,0,29,11055
Conway,926,288,6,30,6,0,4,1260
Cummington,368,139,10,11,2,0,8,538
Dalton,2444,891,38,29,9,0,6,3417
Danvers,7367,6997,122,57,38,0,57,14638
Dartmouth,9880,5985,175,69,33,0,57,16199
Dedham,7757,5734,122,54,42,0,57,13766
Deerfield,2104,839,23,53,8,0,9,3036
Dennis,4921,4247,72,38,0,0,44,9322
Dighton,1743,1843,43,18,16,0,23,3686
Douglas,1897,2542,51,22,0,0,32,4544
Dover,1534,2004,27,12,7,0,9,3593
Dracut,6941,8042,173,51,0,0,112,15319
Dudley,2471,2549,57,18,8,0,15,5118
Dunstable,821,1036,25,11,2,0,6,1901
Duxbury,4247,5325,56,37,15,0,19,9699
E. Bridgewater,3349,3878,66,25,22,0,26,7366
E. Brookfield,470,663,11,4,4,0,5,1157
E. Longmeadow,4092,4528,69,27,19,0,25,8760
Eastham,2188,1446,24,21,11,0,12,3702
Easthampton,6283,2463,103,157,29,0,44,9079
Easton,5262,6060,84,670,31,0,39,12146
Edgartown,1701,827,22,14,6,0,14,2584
Egremont,677,152,4,9,0,0,2,844
Erving,557,200,8,5,3,0,5,778
Essex,1163,966,29,14,1,0,7,2180
Everett,9409,3589,93,45,39,0,66,13241
Fairhaven,5011,3056,107,46,27,0,44,8291
Fall River,21878,7390,299,128,51,0,507,30253
Falmouth,11127,8163,153,112,34,0,54,19643
Fitchburg,8547,5602,216,71,17,0,100,14553
Florida,255,127,7,1,3,0,0,393
Foxborough,4787,4817,99,22,21,0,37,9783
Framingham,18499,8978,265,164,65,0,92,28063
Franklin,8616,8566,176,87,44,0,57,17546
Freetown,2318,2247,66,25,17,0,28,4701
Gardner,4699,3331,117,65,25,0,42,8279
Georgetown,2273,2579,49,17,12,0,17,4947
Gill,653,213,12,18,3,0,1,900
Gloucester,9780,5535,161,79,61,0,73,15689
Goshen,395,198,10,11,0,0,2,616
Gosnold,49,36,1,1,0,0,0,87
Grafton,4877,4438,122,49,18,0,26,9530
Granby,1870,1575,28,28,5,0,25,3531
Granville,377,502,11,4,0,0,6,900
Great Barrington,2928,597,33,43,8,0,12,3621
Greenfield,6187,1895,89,185,31,0,87,8474
Groton,3229,2814,58,49,11,0,201,6362
Groveland,1832,2084,50,17,10,0,9,4002
Hadley,2142,891,26,43,10,0,18,3130
Halifax,1938,2071,48,16,21,0,10,4104
Hamilton,2189,2223,56,26,18,0,17,4529
Hampden,1286,1569,37,13,5,0,8,2918
Hancock,228,142,9,3,0,0,1,383
Hanover,3359,4911,53,20,16,0,37,8396
Hanson,2513,3003,43,14,2,0,50,5625
Hardwick,710,560,27,13,4,0,8,1322
Harvard,2167,1362,46,30,4,0,33,3642
Harwich,4415,3622,65,53,19,0,31,8205
Hatfield,1362,638,11,24,7,0,7,2049
Haverhill,15592,11894,331,110,52,0,144,28123
Hawley,127,65,2,5,2,0,0,201
Heath,295,124,2,8,3,0,3,435
Hingham,6803,7249,93,44,33,0,29,14251
Hinsdale,728,297,26,6,1,0,9,1067
Holbrook,3024,2403,48,24,14,0,33,5546
Holden,5080,5315,100,54,32,0,28,10609
Holland,593,690,27,14,4,0,6,1334
Holliston,4637,3511,102,44,21,0,21,8336
Holyoke,12536,3656,113,144,0,0,122,16571
Hopedale,1701,1536,43,14,3,0,17,3314
Hopkinton,4208,4336,94,31,11,0,23,8703
Hubbardston,1160,1381,31,28,11,0,20,2631
Hudson,5642,4185,139,49,8,0,57,10080
Hull,3584,2418,51,24,12,0,22,6111
Huntington,554,479,52,14,4,0,10,1113
Ipswich,4464,3758,86,52,11,0,42,8413
Kingston,3179,3726,52,13,10,0,26,7006
Lakeville,2422,3312,55,18,25,0,69,5901
Lancaster,1728,1915,44,26,15,0,15,3743
Lanesborough,1144,430,16,6,6,0,10,1612
Lawrence,18278,3462,138,47,37,0,90,22052
Lee,2198,719,26,25,7,0,25,3000
Leicester,2764,2674,74,22,18,0,43,5595
Lenox,2318,675,27,29,10,0,20,3079
Leominster,9792,8552,210,88,52,0,79,18773
Leverett,1004,183,12,39,0,0,4,1242
Lexington,12750,5293,137,160,25,0,74,18439
Leyden,339,115,4,4,0,0,1,463
Lincoln,2613,1074,29,22,4,0,8,3750
Littleton,2939,2363,75,36,16,0,12,5441
Longmeadow,4860,4530,62,39,10,0,17,9518
Lowell,22771,10643,411,191,65,0,145,34226
Ludlow,5240,4295,91,52,20,0,28,9726
Lunenburg,2751,3040,73,36,24,0,24,5948
Lynn,23124,8512,261,113,66,0,181,32257
Lynnfield,2776,4420,53,15,7,0,21,7292
Malden,15010,5730,197,117,51,0,100,21205
Manchester-by-the-Sea,1926,1559,30,18,5,0,5,3543
Mansfield,5932,5870,130,54,0,0,173,12159
Marblehead,6991,5510,102,38,19,0,44,12704
Marion,1727,1458,33,12,2,0,9,3241
Marlborough,9587,6870,188,75,41,0,60,16821
Marshfield,7046,7874,108,56,28,0,43,15155
Mashpee,4135,4062,46,42,11,0,46,8342
Mattapoisett,2041,1855,28,29,0,0,125,4078
Maynard,3635,2023,77,53,15,0,14,5817
Medfield,3448,3864,71,32,9,0,46,7470
Medford,18874,8359,275,227,76,0,131,27942
Medway,3627,3526,70,29,13,0,30,7295
Melrose,9368,5971,133,75,37,0,52,15636
Mendon,1524,1844,34,15,12,0,9,3438
Merrimac,1847,1660,47,18,12,0,20,3604
Methuen,11092,10198,206,50,26,0,100,21672
Middleborough,5224,6053,130,60,30,0,129,11626
Middlefield,202,77,5,6,0,0,4,294
Middleton,1921,2658,36,16,1,0,24,4656
Milford,7159,5519,125,58,37,0,53,12951
Millbury,3411,3263,78,35,17,0,23,6827
Millis,2421,2233,55,28,0,0,38,4775
Millville,717,813,18,9,0,0,8,1565
Milton,9569,6133,114,68,33,0,50,15967
Monroe,32,21,0,0,0,0,0,53
Monson,2178,2035,49,34,7,0,11,4314
Montague,3214,873,39,87,10,0,30,4253
Monterey,420,97,6,9,1,0,3,536
Montgomery,220,274,8,5,2,0,1,510
Mount Washington,83,19,3,3,0,0,2,110
Nahant,1374,898,13,14,5,0,16,2320
Nantucket,3830,2187,60,24,19,0,25,6145
Natick,11685,6792,157,116,25,0,89,18864
Needham,10452,6614,139,52,18,0,151,17426
New Ashford,107,40,5,1,0,0,2,155
New Bedford,25253,7550,320,153,107,0,271,33654
New Braintree,284,257,12,7,0,0,0,560
New Marlborough,573,240,15,9,1,0,4,842
New Salem,381,205,9,11,1,0,1,608
Newbury,2291,2104,36,25,11,0,14,4481
Newburyport,6794,4063,103,65,0,0,38,11063
Newton,32099,12154,353,357,76,0,162,45201
Norfolk,2433,3203,40,35,14,0,16,5741
N. Adams,4465,1152,73,68,18,0,35,5811
N. Andover,7073,8045,112,48,0,0,65,15343
N. Attleborough,6651,7359,166,48,29,0,82,14335
N. Brookfield,1051,1273,32,14,4,0,12,2386
N. Reading,3989,4642,87,27,14,0,45,8804
Northampton,13259,2182,124,508,33,0,321,16427
Northborough,4398,3879,95,40,18,0,80,8510
Northbridge,3445,4109,97,32,18,0,28,7729
Northfield,1115,474,16,23,2,0,8,1638
Norton,4475,4457,99,50,16,0,32,9129
Norwell,2729,3688,47,16,11,0,19,6510
Norwood,8235,6389,141,69,37,0,69,14940
Oak Bluffs,1969,796,15,16,2,0,10,2808
Oakham,509,609,20,8,0,0,6,1152
Orange,1818,1325,65,27,0,0,34,3269
Orleans,2530,1943,27,23,5,0,20,4548
Otis,489,312,18,11,1,0,3,834
Oxford,3126,3263,75,33,23,0,23,6543
Palmer,3018,2468,91,43,21,0,25,5666
Paxton,1124,1362,15,15,3,0,41,2560
Peabody,15027,11622,194,72,84,0,117,27116
Pelham,728,132,6,22,1,0,5,894
Pembroke,4583,5079,84,28,32,0,35,9841
Pepperell,2936,3426,91,30,18,0,27,6528
Peru,324,136,11,3,0,0,1,475
Petersham,451,338,12,13,4,0,4,822
Phillipston,464,469,12,6,0,0,4,955
Pittsfield,15648,4057,205,144,11,0,118,20183
Plainfield,287,83,3,13,0,0,6,392
Plainville,2087,2281,38,22,0,0,60,4488
Plymouth,15233,14347,261,111,80,0,89,30121
Plympton,780,930,19,15,2,0,6,1752
Princeton,1115,1149,32,10,2,0,22,2330
Provincetown,2121,210,19,30,4,0,6,2390
Quincy,24849,14850,393,233,131,0,178,40634
Randolph,11441,3552,93,40,23,0,42,15191
Raynham,3222,3658,76,17,0,0,43,7016
Reading,7515,6683,106,69,38,0,37,14448
Rehoboth,2914,3247,75,24,0,0,82,6342
Revere,11665,5921,135,75,36,0,182,18014
Richmond,702,228,6,3,0,0,6,945
Rochester,1366,1704,46,13,2,0,15,3146
Rockland,4597,4051,91,38,28,0,26,8831
Rockport,2982,1671,62,30,8,0,21,4774
Rowe,140,92,4,5,0,0,2,243
Rowley,1596,1935,36,15,5,0,7,3594
Royalston,391,267,8,10,2,0,0,678
Russell,388,386,10,4,2,0,7,797
Rutland,2075,2332,47,24,16,0,21,4515
Salem,13605,5725,229,148,31,0,109,19847
Salisbury,2280,1939,46,15,13,0,21,4314
Sandisfield,294,154,4,3,0,0,6,461
Sandwich,5845,6511,96,45,12,0,43,12552
Saugus,6990,6590,111,31,18,0,81,13821
Savoy,241,103,8,3,1,0,3,359
Scituate,5582,5697,91,45,10,0,58,11483
Seekonk,3788,3390,86,29,17,0,30,7340
Sharon,6564,3665,71,50,20,0,28,10398
Sheffield,1291,503,16,22,3,0,7,1842
Shelburne,873,226,11,24,10,0,8,1152
Sherborn,1452,1182,34,12,5,0,4,2689
Shirley,1554,1483,65,30,7,0,7,3146
Shrewsbury,9754,8180,164,63,36,0,57,18254
Shutesbury,1028,156,16,50,4,0,5,1259
Somerset,6134,3697,104,40,15,0,116,10106
Somerville,28853,4885,547,761,110,0,334,35490
S. Hadley,5437,3273,103,52,25,0,29,8919
Southampton,1866,1590,35,38,16,0,11,3556
Southborough,2956,2791,63,24,16,0,17,5867
Southbridge,4284,2295,80,42,17,0,15,6733
Southwick,2050,2772,53,28,18,0,17,4938
Spencer,2617,2785,99,29,20,0,25,5575
Springfield,43869,10515,361,216,108,0,674,55743
Sterling,2050,2679,63,18,5,0,28,4843
Stockbridge,945,226,22,16,1,0,7,1217
Stoneham,6696,5609,108,49,9,0,54,12525
Stoughton,8119,5594,132,48,28,0,68,13989
Stow,2354,1835,53,24,6,0,16,4288
Sturbridge,2534,2624,85,32,16,0,7,5298
Sudbury,6133,4387,75,43,18,0,23,10679
Sunderland,1366,404,39,56,3,0,9,1877
Sutton,2189,3097,59,30,12,0,15,5402
Swampscott,4936,3209,72,35,10,0,38,8300
Swansea,4516,3277,80,22,0,0,49,7944
Taunton,13769,8925,279,83,56,0,121,23233
Templeton,1860,1857,44,25,9,0,19,3814
Tewksbury,7578,8360,144,67,56,0,54,16259
Tisbury,1845,595,16,29,11,0,27,2523
Tolland,110,155,7,6,1,0,0,279
Topsfield,1801,2164,32,14,8,0,73,4092
Townsend,2088,2728,88,23,0,0,29,4956
Truro,1043,399,18,9,1,0,6,1476
Tyngsborough,2840,3363,77,18,10,0,27,6335
Tyringham,173,85,0,0,0,0,3,261
Upton,1995,2142,61,22,11,0,11,4242
Uxbridge,3321,3728,97,30,21,0,25,7222
Wakefield,7515,6820,134,52,38,0,60,14619
Wales,482,434,11,3,5,0,0,935
Walpole,6385,7466,122,46,28,0,56,14103
Waltham,15906,8856,293,214,47,0,85,25401
Ware,2393,1789,54,23,18,0,24,4301
Wareham,6098,4650,107,49,37,0,35,10976
Warren,1219,1002,60,22,14,0,11,2328
Warwick,334,109,5,5,2,0,3,458
Washington,239,69,4,3,1,0,4,320
Watertown,11912,4526,170,155,37,0,63,16863
Wayland,5170,2976,71,61,11,0,21,8310
Webster,3476,3116,82,37,19,0,32,6762
Wellesley,8530,6264,103,64,0,0,220,15181
Wellfleet,1569,619,28,27,1,0,9,2253
Wendell,427,70,17,43,0,0,4,561
Wenham,1060,1266,27,9,0,0,11,2373
W. Boylston,2046,2091,41,14,2,0,21,4215
W. Bridgewater,1735,2171,28,24,0,0,31,3989
W. Brookfield,965,951,22,10,1,0,13,1962
W. Newbury,1390,1349,29,8,7,0,14,2797
W. Springfield,6175,5172,111,65,20,0,52,11595
W. Stockbridge,707,161,12,6,0,0,3,889
W. Tisbury,1573,373,17,16,6,0,5,1990
Westborough,5089,3897,79,59,23,0,110,9257
Westfield,9281,8218,213,120,50,0,93,17975
Westford,6406,6309,156,57,14,0,34,12976
Westhampton,639,385,16,18,1,0,5,1064
Westminster,1947,2248,49,42,8,0,16,4310
Weston,3430,3177,45,27,16,0,25,6720
Westport,5095,3386,102,40,0,0,68,8691
Westwood,4393,4575,70,38,12,0,41,9129
Weymouth,15166,12362,226,139,92,0,104,28089
Whately,627,301,14,19,0,0,3,964
Whitman,3655,3656,74,43,29,0,40,7497
Wilbraham,3746,4334,87,41,10,0,151,8369
Williamsburg,1240,325,17,43,3,0,6,1634
Williamstown,3070,646,37,36,8,0,13,3810
Wilmington,5904,6452,120,42,35,0,50,12603
Winchendon,2142,1933,59,26,22,0,19,4201
Winchester,7107,5635,103,64,28,0,40,12977
Windsor,385,127,2,8,3,0,3,528
Winthrop,5239,3578,64,46,27,0,42,8996
Woburn,10385,8730,162,83,26,0,100,19486
Worcester,42210,17949,613,445,176,0,315,61708
Worthington,481,208,11,24,2,0,4,730
Wrentham,2718,3542,57,32,8,0,10,6367
Yarmouth,7198,6541,87,76,15,0,64,13981
