City/Town,Kerry/ Edwards,Bush/ Cheney,Badnarik/ Campagna,Cobb/ LaMarche,Nader/ Camejo,All Others,No Preference,Blanks,Total Votes Cast
Abington,4192,3447,33,13,0,24,0,22,7731
Acton,7063,3485,86,41,15,48,0,61,10799
Acushnet,3790,1697,16,16,7,9,0,39,5574
Adams,3046,973,17,13,8,5,0,11,4073
Agawam,7691,5957,58,35,0,35,0,255,14031
Alford,208,89,3,1,2,0,0,0,303
Amesbury,4589,3228,49,22,14,11,0,24,7937
Amherst,9745,1466,63,178,82,23,0,35,11592
Andover,9205,7907,106,61,51,33,0,47,17410
Aquinnah,270,22,1,2,1,0,0,0,296
Arlington,17856,6428,162,137,71,79,0,72,24805
Ashburnham,1654,1426,13,13,8,5,0,7,3126
Ashby,829,891,10,14,3,2,0,2,1751
Ashfield,839,236,5,12,0,3,0,9,1104
Ashland,4729,3046,38,21,11,15,0,19,7879
Athol,2475,2095,33,24,8,9,0,13,4657
Attleboro,9857,7714,112,59,57,43,0,42,17884
Auburn,5002,3738,40,18,8,10,0,22,8838
Avon,1357,1046,12,6,5,7,0,20,2453
Ayer,1616,1316,19,13,4,0,0,17,2985
Barnstable,13236,11938,105,87,0,77,0,111,25554
Barre,1323,1174,17,11,5,3,0,13,2546
Becket,539,282,9,3,10,3,0,2,848
Bedford,4159,2593,51,30,23,39,0,19,6914
Belchertown,4302,2460,28,40,14,7,0,18,6869
Bellingham,4361,3399,39,26,25,13,0,19,7882
Belmont,8961,4287,80,64,46,30,0,52,13520
Berkley,1543,1357,17,17,8,6,0,7,2955
Berlin,844,696,14,6,0,0,0,13,1573
Bernardston,762,448,9,6,0,6,0,5,1236
Beverly,11543,7791,127,55,42,67,0,52,19677
Billerica,9463,8472,113,54,34,52,0,34,18222
Blackstone,2209,1816,22,12,5,8,0,9,4081
Blandford,315,335,7,7,3,0,0,2,669
Bolton,1427,1180,19,18,10,5,0,5,2664
Boston,160884,44518,942,985,325,582,0,466,208702
Bourne,4936,4788,35,24,10,34,0,33,9860
Boxborough,1539,990,20,10,12,11,0,7,2589
Boxford,2064,2664,29,10,15,14,0,15,4811
Boylston,1302,1113,19,10,0,10,0,13,2467
Braintree,10219,7797,71,42,20,52,0,60,18261
Brewster,3827,2727,36,24,23,14,0,38,6689
Bridgewater,5589,5529,63,21,18,22,0,48,11290
Brimfield,920,894,6,11,3,6,0,5,1845
Brockton,20091,10058,129,66,50,35,0,79,30508
Brookfield,817,782,9,7,0,10,0,11,1636
Brookline,21256,5269,133,140,97,54,0,85,27034
Buckland,684,312,2,11,1,0,0,26,1036
Burlington,6747,5241,73,27,26,15,0,35,12164
Cambridge,35886,5338,309,430,208,124,0,148,42443
Canton,6476,4875,50,21,21,15,0,49,11507
Carlisle,1947,1124,23,16,0,19,0,15,3144
Carver,3054,2731,27,22,4,12,0,29,5879
Charlemont,433,223,5,7,2,0,0,2,672
Charlton,2639,2983,30,12,6,14,0,16,5700
Chatham,2423,2341,16,10,10,13,0,107,4920
Chelmsford,9688,8485,125,69,54,43,0,52,18516
Chelsea,5145,1833,24,22,8,0,0,134,7166
Cheshire,1254,543,3,15,4,1,0,11,1831
Chester,322,330,4,4,0,3,0,3,666
Chesterfield,363,293,2,10,0,2,0,3,673
Chicopee,14642,7957,115,66,0,77,0,104,22961
Chilmark,583,156,1,4,0,2,0,1,747
Clarksburg,598,268,1,2,0,0,0,8,877
Clinton,3559,2429,42,23,0,29,0,40,6122
Cohasset,2288,2165,25,12,10,10,0,16,4526
Colrain,545,314,9,6,0,2,0,0,876
Concord,6800,3182,60,63,34,34,0,32,10205
Conway,846,309,14,11,3,3,0,8,1194
Cummington,370,173,1,3,0,0,0,2,549
Dalton,2448,1041,11,7,11,6,0,8,3532
Danvers,7052,6090,63,28,24,35,0,45,13337
Dartmouth,10218,4855,71,35,16,20,0,36,15251
Dedham,7410,4866,66,35,0,0,0,98,12475
Deerfield,2115,861,14,14,0,0,0,22,3026
Dennis,5246,4325,45,36,20,0,0,96,9768
Dighton,1745,1477,17,13,7,8,0,6,3273
Douglas,1866,2048,18,13,7,0,0,17,3969
Dover,1605,1688,25,14,10,11,0,10,3363
Dracut,6974,6671,59,42,0,0,0,125,13871
Dudley,2618,2177,16,12,8,9,0,19,4859
Dunstable,843,883,12,1,7,7,0,4,1757
Duxbury,4464,4583,47,31,27,14,0,23,9189
E. Bridgewater,3121,3401,31,10,6,8,0,19,6596
E. Brookfield,467,623,1,4,0,3,0,2,1100
E. Longmeadow,4206,4001,17,14,0,20,0,70,8328
Eastham,2227,1480,23,10,11,0,0,31,3782
Easthampton,5500,2654,48,55,26,16,0,36,8335
Easton,5878,5436,58,33,28,17,0,27,11477
Edgartown,1539,793,5,9,0,1,0,10,2357
Egremont,593,199,4,5,0,0,0,11,812
Erving,500,263,5,2,0,7,0,4,781
Essex,1123,954,21,6,0,2,0,7,2113
Everett,8719,4025,52,25,0,28,0,39,12888
Fairhaven,5683,2418,36,15,10,7,0,25,8194
Fall River,23859,7369,105,86,44,97,0,242,31802
Falmouth,11274,7807,65,87,54,45,0,66,19398
Fitchburg,8433,5023,66,45,25,29,0,39,13660
Florida,267,132,1,2,1,0,0,2,405
Foxborough,4622,4010,50,27,23,13,0,33,8778
Framingham,17239,8448,158,73,0,125,0,151,26194
Franklin,8268,6974,78,41,21,42,0,56,15480
Freetown,2454,1938,18,4,13,14,0,31,4472
Gardner,5027,2956,46,39,15,15,0,28,8126
Georgetown,2103,2091,26,14,5,10,0,12,4261
Gill,620,265,3,12,4,2,0,8,914
Gloucester,9536,5185,91,63,21,52,0,128,15076
Goshen,361,203,6,5,1,1,0,1,578
Gosnold,41,34,0,2,0,0,0,0,77
Grafton,4295,3656,47,31,15,14,0,23,8081
Granby,1895,1406,14,12,6,8,0,3,3344
Granville,374,449,4,8,0,0,0,4,839
Great Barrington,2936,730,17,27,11,11,0,23,3755
Greenfield,5974,2369,48,70,32,8,0,66,8567
Groton,3167,2545,39,20,25,14,0,41,5851
Groveland,1782,1755,20,15,7,15,0,0,3594
Hadley,2054,953,19,25,0,19,0,15,3085
Halifax,1894,1893,20,8,6,6,0,6,3833
Hamilton,2120,2381,35,18,0,21,0,20,4595
Hampden,1379,1421,15,15,2,2,0,14,2848
Hancock,251,143,1,2,0,0,0,2,399
Hanover,3566,3968,34,16,18,0,0,20,7622
Hanson,2570,2536,19,14,0,13,0,22,5174
Hardwick,778,549,13,6,0,1,0,6,1353
Harvard,2086,1206,36,9,12,34,0,22,3405
Harwich,4333,3690,38,31,26,10,0,102,8230
Hatfield,1369,690,7,13,4,3,0,7,2093
Haverhill,13919,10332,139,71,45,71,0,149,24726
Hawley,121,68,1,4,0,1,0,0,195
Heath,268,156,1,5,1,0,0,3,434
Hingham,6230,5612,61,24,0,58,0,140,12125
Hinsdale,741,310,6,1,4,1,0,9,1072
Holbrook,3044,2285,27,11,10,8,0,16,5401
Holden,4989,4688,60,23,34,12,0,38,9844
Holland,570,578,7,3,0,1,0,8,1167
Holliston,4571,3073,59,25,0,26,0,20,7774
Holyoke,10033,4514,63,63,27,24,0,86,14810
Hopedale,1829,1379,20,15,5,3,0,30,3281
Hopkinton,3897,3595,57,21,20,23,0,30,7643
Hubbardston,1065,1106,10,11,6,6,0,11,2215
Hudson,5270,3486,65,32,16,4,0,59,8932
Hull,3748,2033,29,18,5,12,0,12,5857
Huntington,532,499,10,12,9,0,0,4,1066
Ipswich,4281,3356,48,28,28,23,0,42,7806
Kingston,3228,3058,23,17,13,7,0,22,6368
Lakeville,2395,2914,40,15,14,0,0,26,5404
Lancaster,1664,1656,22,15,8,10,0,24,3399
Lanesborough,1128,482,5,1,0,3,0,6,1625
Lawrence,11547,4796,62,53,0,0,0,123,16581
Lee,2150,855,16,4,8,5,0,21,3059
Leicester,2774,2315,19,19,6,15,0,20,5168
Lenox,2248,795,13,7,7,0,0,20,3090
Leominster,10004,7289,103,82,0,60,0,60,17598
Leverett,950,193,3,14,0,3,0,6,1169
Lexington,12334,4834,86,75,46,52,0,40,17467
Leyden,311,138,4,5,1,0,0,3,462
Lincoln,2442,914,21,18,13,6,0,11,3425
Littleton,2770,2010,48,18,11,0,0,31,4888
Longmeadow,5157,3627,29,25,10,4,0,243,9095
Lowell,18195,10554,169,112,54,38,0,110,29232
Ludlow,5688,3583,29,29,12,13,0,12,9366
Lunenburg,2832,2475,30,26,0,0,0,40,5403
Lynn,19372,8373,103,62,0,97,0,129,28136
Lynnfield,3169,3626,24,14,14,11,0,54,6912
Malden,14011,5730,95,44,0,89,0,73,20042
Manchester-by-the-Sea,1825,1427,24,10,9,7,0,12,3314
Mansfield,5775,4933,63,30,20,0,0,66,10887
Marblehead,7140,4755,80,39,0,62,0,36,12112
Marion,1744,1270,21,11,3,11,0,15,3075
Marlborough,8825,6407,107,51,20,49,0,174,15633
Marshfield,6951,6387,59,31,0,74,0,78,13580
Mashpee,4076,3561,20,17,0,25,0,95,7794
Mattapoisett,2201,1655,14,11,8,6,0,15,3910
Maynard,3446,1984,37,28,14,9,0,12,5530
Medfield,3618,3214,43,22,12,11,0,44,6964
Medford,17737,7932,138,107,0,104,0,151,26169
Medway,3613,3087,34,22,0,38,0,12,6806
Melrose,9386,5640,77,41,27,45,0,52,15268
Mendon,1423,1576,27,4,4,4,0,12,3050
Merrimac,1796,1568,22,10,4,8,0,5,3413
Methuen,10037,9075,101,32,26,16,0,93,19380
Middleborough,4785,5125,55,21,13,30,0,63,10092
Middlefield,179,118,2,1,1,1,0,0,302
Middleton,1835,1936,19,9,12,12,0,4,3827
Milford,7015,4776,63,24,0,18,0,66,11962
Millbury,3422,2739,36,16,0,15,0,34,6262
Millis,2407,1924,29,29,14,9,0,28,4440
Millville,719,688,5,4,0,2,0,6,1424
Milton,9238,5465,73,35,12,37,0,81,14941
Monroe,40,21,0,1,0,0,0,0,62
Monson,2239,1774,26,9,12,12,0,10,4082
Montague,2913,1137,14,73,11,11,0,39,4198
Monterey,414,120,2,6,1,0,0,3,546
Montgomery,213,249,3,5,1,0,0,0,471
Mount Washington,76,25,0,5,0,1,0,1,108
Nahant,1395,819,12,3,1,3,0,26,2259
Nantucket,3608,2040,22,22,0,32,0,24,5748
Natick,10848,6000,116,57,40,44,0,218,17323
Needham,10775,5846,84,42,28,46,0,84,16905
New Ashford,92,53,2,0,0,0,0,1,148
New Bedford,25551,7328,109,86,0,114,0,256,33444
New Braintree,263,243,1,3,0,1,0,2,513
New Marlborough,541,258,9,8,0,6,0,6,828
New Salem,359,221,6,3,0,0,0,1,590
Newbury,2159,1862,28,17,4,9,0,13,4092
Newburyport,6490,3681,81,41,26,23,0,88,10430
Newton,32061,10025,217,153,72,94,0,96,42718
Norfolk,2282,2626,39,12,13,19,0,64,5055
N. Adams,4452,1442,20,18,10,3,0,75,6020
N. Andover,6760,6891,68,37,46,10,0,43,13855
N. Attleborough,6815,6496,75,30,34,36,0,111,13597
N. Brookfield,1011,1187,14,6,0,14,0,8,2240
N. Reading,3906,3883,54,18,8,8,0,35,7912
Northampton,12233,2793,87,174,66,44,0,98,15495
Northborough,4234,3352,47,29,0,32,0,53,7747
Northbridge,3337,3462,39,18,12,12,0,13,6893
Northfield,1127,581,11,12,3,1,0,6,1741
Norton,4241,3773,41,25,22,0,0,29,8131
Norwell,2858,3060,40,7,6,13,0,4,5988
Norwood,8162,5568,64,48,39,33,0,102,14016
Oak Bluffs,1770,698,13,10,4,7,0,5,2507
Oakham,494,500,9,1,5,2,0,4,1015
Orange,1582,1534,20,19,0,14,0,11,3180
Orleans,2420,2061,24,12,10,8,0,168,4703
Otis,422,320,3,5,0,0,0,3,753
Oxford,3300,2817,26,21,10,10,0,14,6198
Palmer,3538,2430,30,14,9,2,0,58,6081
Paxton,1271,1166,11,9,5,0,0,30,2492
Peabody,15249,9531,91,47,21,77,0,163,25179
Pelham,695,151,2,10,4,1,0,1,864
Pembroke,4642,4237,46,15,16,10,0,19,8985
Pepperell,2887,2931,40,21,11,14,0,13,5917
Peru,252,148,3,1,0,0,0,2,406
Petersham,439,336,6,6,1,2,0,3,793
Phillipston,396,427,2,2,2,1,0,3,833
Pittsfield,15269,4991,70,78,26,10,0,123,20567
Plainfield,256,105,3,6,0,2,0,2,374
Plainville,2017,1898,20,14,13,5,0,15,3982
Plymouth,14198,11892,102,68,50,44,0,56,26410
Plympton,801,823,14,2,4,0,0,4,1648
Princeton,1106,1012,11,7,5,9,0,14,2164
Provincetown,2151,284,9,16,0,2,0,15,2477
Quincy,24173,13373,170,97,96,90,0,183,38182
Randolph,9593,3758,45,27,22,15,0,29,13489
Raynham,3223,3086,22,11,6,3,0,13,6364
Reading,7332,5240,62,42,20,20,0,195,12911
Rehoboth,2886,2662,33,22,0,14,0,62,5679
Revere,10983,5355,62,37,16,29,0,147,16629
Richmond,751,226,6,3,7,5,0,2,1000
Rochester,1392,1374,18,7,5,6,0,13,2815
Rockland,4585,3653,38,26,12,13,0,34,8361
Rockport,2936,1637,17,25,7,14,0,21,4657
Rowe,136,112,3,1,0,1,0,0,253
Rowley,1455,1645,22,6,3,4,0,16,3151
Royalston,338,272,7,6,0,1,0,4,628
Russell,389,383,9,3,3,0,0,5,792
Rutland,1775,1851,17,9,13,4,0,9,3678
Salem,12286,5563,98,68,29,39,0,57,18140
Salisbury,2202,1721,13,4,8,7,0,14,3969
Sandisfield,268,133,3,9,3,1,0,1,418
Sandwich,5863,5982,44,36,19,13,0,91,12048
Saugus,7736,5568,54,24,31,24,0,34,13471
Savoy,225,112,1,2,1,0,0,1,342
Scituate,5673,5075,54,30,22,43,0,40,10937
Seekonk,3956,3061,35,24,5,22,0,37,7140
Sharon,6760,2788,50,29,19,18,0,144,9808
Sheffield,1211,573,8,18,0,9,0,9,1828
Shelburne,809,300,6,13,6,1,0,24,1159
Sherborn,1498,1108,23,12,9,4,0,10,2664
Shirley,1533,1325,15,26,6,8,0,6,2919
Shrewsbury,8989,7113,83,44,41,15,0,298,16583
Shutesbury,987,146,10,17,8,1,0,3,1172
Somerset,6769,3215,40,20,15,10,0,98,10167
Somerville,24300,5232,225,308,97,115,0,153,30430
S. Hadley,5338,3166,35,25,28,10,0,32,8634
Southampton,1677,1462,8,20,2,9,0,4,3182
Southborough,2919,2446,39,16,18,10,0,15,5463
Southbridge,3983,2514,29,21,9,11,0,10,6577
Southwick,2083,2315,29,20,10,9,0,43,4509
Spencer,2767,2506,29,27,12,11,0,7,5359
Springfield,33583,13028,150,140,5,167,0,370,47443
Sterling,2093,2252,41,24,16,5,0,11,4442
Stockbridge,982,247,7,7,3,1,0,13,1260
Stoneham,6952,4741,41,24,15,22,0,42,11837
Stoughton,8252,4896,67,28,27,14,0,103,13387
Stow,2203,1468,37,22,8,6,0,10,3754
Sturbridge,2472,2147,34,5,0,17,0,8,4683
Sudbury,6101,3607,71,30,27,36,0,22,9894
Sunderland,1294,379,17,36,12,5,0,10,1753
Sutton,2186,2484,35,14,0,18,0,46,4783
Swampscott,5191,2679,35,21,3,28,0,90,8047
Swansea,5256,3036,35,33,0,28,0,21,8409
Taunton,13206,7804,82,54,0,77,0,65,21288
Templeton,1869,1431,25,11,0,0,0,31,3367
Tewksbury,7739,6889,76,33,15,25,0,37,14814
Tisbury,1669,566,10,11,10,10,0,12,2288
Tolland,109,128,1,0,0,0,0,0,238
Topsfield,1731,1890,32,16,12,8,0,44,3733
Townsend,2179,2421,35,16,0,22,0,5,4678
Truro,1049,392,10,5,2,0,0,6,1464
Tyngsborough,2751,2815,23,13,11,22,0,9,5644
Tyringham,172,92,0,0,0,0,0,2,266
Upton,1966,1727,29,9,11,14,0,5,3761
Uxbridge,3456,3094,28,17,0,20,0,16,6631
Wakefield,7920,5647,73,26,36,26,0,56,13784
Wales,466,415,7,4,2,2,0,0,896
Walpole,6503,6119,50,26,22,37,0,24,12781
Waltham,14517,8228,148,88,28,34,0,327,23370
Ware,2594,1658,14,12,5,3,0,22,4308
Wareham,5941,4103,44,27,18,18,0,29,10180
Warren,1152,1005,14,4,8,3,0,6,2192
Warwick,269,123,2,3,0,0,0,1,398
Washington,211,104,1,0,2,1,0,2,321
Watertown,10970,4191,94,73,0,88,0,145,15561
Wayland,5157,2595,50,22,0,42,0,35,7901
Webster,3589,2830,27,19,11,14,0,12,6502
Wellesley,8614,5211,67,44,35,38,0,212,14221
Wellfleet,1443,622,12,12,0,12,0,9,2110
Wendell,429,69,8,21,5,0,0,2,534
Wenham,1076,1154,18,8,0,0,0,15,2271
W. Boylston,1908,1775,30,20,9,5,0,14,3761
W. Bridgewater,1668,1991,22,9,6,11,0,12,3719
W. Brookfield,963,889,16,9,0,4,0,6,1887
W. Newbury,1364,1183,18,9,5,3,0,8,2590
W. Springfield,6646,5012,53,49,19,14,0,48,11841
W. Stockbridge,691,196,6,7,3,0,0,3,906
W. Tisbury,1393,333,3,15,5,4,0,6,1759
Westborough,4905,3497,54,27,26,16,0,207,8732
Westfield,9064,7568,90,57,36,26,0,143,16984
Westford,5991,5413,85,48,35,39,0,37,11648
Westhampton,573,409,5,7,4,2,0,7,1007
Westminster,2011,1936,28,12,11,1,0,26,4025
Weston,3640,2574,44,20,0,44,0,26,6348
Westport,5149,2869,37,20,28,0,0,36,8139
Westwood,4372,3848,57,25,0,38,0,27,8367
Weymouth,15367,10912,112,59,50,61,0,63,26624
Whately,637,280,5,9,0,3,0,1,935
Whitman,3597,3195,37,16,15,11,0,30,6901
Wilbraham,4083,3977,50,23,14,13,0,80,8240
Williamsburg,1144,388,9,20,5,13,0,6,1585
Williamstown,2949,759,13,11,4,10,0,20,3766
Wilmington,5840,5316,57,26,17,9,0,21,11286
Winchendon,2129,1818,24,11,6,15,0,10,4013
Winchester,7106,4814,85,38,35,22,0,61,12161
Windsor,358,165,3,1,0,1,0,2,530
Winthrop,5580,3217,47,24,14,13,0,49,8944
Woburn,10322,7743,90,42,28,8,0,80,18313
Worcester,38264,17648,293,220,0,231,0,295,56951
Worthington,500,268,4,5,3,3,0,4,787
Wrentham,2740,2856,47,11,15,17,0,14,5700
Yarmouth,7652,6529,54,41,26,17,0,104,14423
